市区町村コード,都道府県,名称（空白なし）,名称,人口　平成27年,人口　平成22年（組替）,平成22年〜27年の人口増減数,平成22年〜27年の人口増減率（％）,面積（km2）,人口密度（1km2当たり）,世帯数　平成27年,世帯数　平成22年（組替）,平成22年〜27年の世帯増減数,平成22年〜27年の世帯増減率（％）
01101,北海道,札幌市中央区,札幌市 中央区,237784,220189,17595,7.9908623955,46.42,5122.4,131598,120741,10857,8.9919745571
01102,北海道,札幌市北区,札幌市 北区,285432,278781,6651,2.3857436482,63.57,4490.0,133522,127440,6082,4.7724419335
01103,北海道,札幌市東区,札幌市 東区,262075,255873,6202,2.4238587112,56.97,4600.2,124424,118939,5485,4.6116076308
01104,北海道,札幌市白石区,札幌市 白石区,209770,204259,5511,2.6980451290,34.47,6085.6,103548,100444,3104,3.0902791605
01105,北海道,札幌市豊平区,札幌市 豊平区,218792,212118,6674,3.1463619306,46.23,4732.7,109439,107179,2260,2.1086220248
01106,北海道,札幌市南区,札幌市 南区,141358,146341,-4983,-3.4050607827,657.48,215.0,61197,62776,-1579,-2.5152924685
01107,北海道,札幌市西区,札幌市 西区,213822,211229,2593,1.2275776527,75.10,2847.2,97677,96421,1256,1.3026207984
01108,北海道,札幌市厚別区,札幌市 厚別区,127826,128492,-666,-0.5183202067,24.38,5243.1,55540,54099,1441,2.6636351873
01109,北海道,札幌市手稲区,札幌市 手稲区,141061,139644,1417,1.0147231532,56.77,2484.8,57206,55050,2156,3.9164396004
01110,北海道,札幌市清田区,札幌市 清田区,115864,116619,-755,-0.6474073693,59.87,1935.3,45047,42759,2288,5.3509202741
01202,北海道,函館市,函館市,266117,279127,-13010,-4.6609607813,677.83,392.6,123968,126180,-2212,-1.7530511967
01203,北海道,小樽市,小樽市,121910,131928,-10018,-7.5935358680,243.83,500.0,55266,57711,-2445,-4.2366273327
01204,北海道,旭川市,旭川市,339797,347095,-7298,-2.1025943906,747.66,454.5,155756,154393,1363,0.8828120446
01205,北海道,室蘭市,室蘭市,88585,94535,-5950,-6.2939651981,80.88,1095.3,43552,45029,-1477,-3.2801083746
01206,北海道,釧路市,釧路市,174804,181169,-6365,-3.5132942170,1362.92,128.3,82111,81015,1096,1.3528358946
01207,北海道,帯広市,帯広市,169389,168057,1332,0.7925882290,619.34,273.5,77679,75474,2205,2.9215358932
01208,北海道,北見市,北見市,120652,125689,-5037,-4.0075106016,1427.41,84.5,55569,56012,-443,-0.7909019496
01209,北海道,夕張市,夕張市,8845,10922,-2077,-19.0166636147,763.07,11.6,4526,5558,-1032,-18.5678301547
01210,北海道,岩見沢市,岩見沢市,84541,90145,-5604,-6.2166509512,481.02,175.8,36156,36723,-567,-1.5439915040
01211,北海道,網走市,網走市,38966,40998,-2032,-4.9563393336,471.00,82.7,17984,18112,-128,-0.7067137809
01212,北海道,留萌市,留萌市,22227,24457,-2230,-9.1180439138,297.83,74.6,10399,11044,-645,-5.8402752626
01213,北海道,苫小牧市,苫小牧市,172794,173320,-526,-0.3034848835,561.57,307.7,78229,76289,1940,2.5429616327
01214,北海道,稚内市,稚内市,36399,39595,-3196,-8.0717262281,761.49,47.8,16501,17343,-842,-4.8549847201
01215,北海道,美唄市,美唄市,23048,26034,-2986,-11.4696166551,277.69,83.0,10175,10992,-817,-7.4326783115
01216,北海道,芦別市,芦別市,14686,16628,-1942,-11.6790955016,865.04,17.0,6858,7526,-668,-8.8758968908
01217,北海道,江別市,江別市,120677,123722,-3045,-2.4611629298,187.38,644.0,51932,51170,762,1.4891538011
01218,北海道,赤平市,赤平市,11097,12637,-1540,-12.1864366543,129.88,85.4,4947,5585,-638,-11.4234556849
01219,北海道,紋別市,紋別市,23080,24750,-1670,-6.7474747475,830.78,27.8,11095,11390,-295,-2.5899912204
01220,北海道,士別市,士別市,19930,21787,-1857,-8.5234314040,1119.22,17.8,8655,9100,-445,-4.8901098901
01221,北海道,名寄市,名寄市,29060,30591,-1531,-5.0047399562,535.20,54.3,13083,13348,-265,-1.9853161522
01222,北海道,三笠市,三笠市,9080,10221,-1141,-11.1632912631,302.52,30.0,4225,4776,-551,-11.5368509213
01223,北海道,根室市,根室市,26919,29201,-2282,-7.8148008630,506.25,65.4,11376,11897,-521,-4.3792552744
01224,北海道,千歳市,千歳市,95664,93604,2060,2.2007606513,594.50,160.9,40614,38541,2073,5.3786876314
01225,北海道,滝川市,滝川市,41209,43170,-1961,-4.5425063702,115.90,355.6,18631,18947,-316,-1.6678102074
01226,北海道,砂川市,砂川市,17702,19056,-1354,-7.1053736356,78.68,225.0,7870,8415,-545,-6.4765300059
01227,北海道,歌志内市,歌志内市,3587,4387,-800,-18.2356963757,55.95,64.1,1667,2000,-333,-16.6500000000
01228,北海道,深川市,深川市,21934,23709,-1775,-7.4866084609,529.42,41.4,9695,10100,-405,-4.0099009901
01229,北海道,富良野市,富良野市,22947,24259,-1312,-5.4083020735,600.71,38.2,9928,10074,-146,-1.4492753623
01230,北海道,登別市,登別市,49656,51526,-1870,-3.6292357257,212.21,234.0,21682,21717,-35,-0.1611640650
01231,北海道,恵庭市,恵庭市,69745,69384,361,0.5202928629,294.65,236.7,28612,27634,978,3.5391184772
01233,北海道,伊達市,伊達市,35026,36278,-1252,-3.4511274050,444.21,78.9,15051,15287,-236,-1.5437953817
01234,北海道,北広島市,北広島市,59087,60353,-1266,-2.0976587742,119.05,496.3,23561,22991,570,2.4792310034
01235,北海道,石狩市,石狩市,57462,59449,-1987,-3.3423606789,722.42,79.5,22426,22603,-177,-0.7830818918
01236,北海道,北斗市,北斗市,46416,48032,-1616,-3.3644237175,397.44,116.8,18414,18412,2,0.0108624810
01300,北海道,石狩振興局,石狩振興局,20622,22281,-1659,-7.4458058435,500.89,41.2,8392,8486,-94,-1.1077068112
01303,北海道,当別町,当別町,17290,18766,-1476,-7.8652882873,422.86,40.9,7327,7400,-73,-0.9864864865
01304,北海道,新篠津村,新篠津村,3332,3515,-183,-5.2062588905,78.04,42.7,1065,1086,-21,-1.9337016575
01330,北海道,渡島総合振興局,渡島総合振興局,92454,100648,-8194,-8.1412447341,2862.11,32.3,39289,40887,-1598,-3.9083327219
01331,北海道,松前町,松前町,7336,8748,-1412,-16.1408321902,293.25,25.0,3563,3959,-396,-10.0025258904
01332,北海道,福島町,福島町,4423,5114,-691,-13.5119280407,187.28,23.6,2039,2194,-155,-7.0647219690
01333,北海道,知内町,知内町,4654,5074,-420,-8.2774931021,196.75,23.7,2004,2009,-5,-0.2488800398
01334,北海道,木古内町,木古内町,4545,5341,-796,-14.9035761093,221.87,20.5,2140,2317,-177,-7.6391886060
01337,北海道,七飯町,七飯町,28130,28463,-333,-1.1699399220,216.75,129.8,11045,10891,154,1.4140115692
01343,北海道,鹿部町,鹿部町,4227,4767,-540,-11.3278791693,110.64,38.2,1659,1675,-16,-0.9552238806
01345,北海道,森町,森町,15950,17859,-1909,-10.6892883140,368.79,43.2,6629,7103,-474,-6.6732366606
01346,北海道,八雲町,八雲町,17262,18896,-1634,-8.6473327688,956.02,18.1,7529,7892,-363,-4.5995945261
01347,北海道,長万部町,長万部町,5927,6386,-459,-7.1875978703,310.76,19.1,2681,2847,-166,-5.8306989814
01360,北海道,檜山振興局,檜山振興局,37863,42058,-4195,-9.9743211755,2630.29,14.4,16821,17927,-1106,-6.1694650527
01361,北海道,江差町,江差町,8239,9004,-765,-8.4962239005,109.53,75.2,3748,3968,-220,-5.5443548387
01362,北海道,上ノ国町,上ノ国町,4869,5428,-559,-10.2984524687,547.71,8.9,2175,2307,-132,-5.7217165150
01363,北海道,厚沢部町,厚沢部町,4055,4409,-354,-8.0290315264,460.58,8.8,1764,1868,-104,-5.5674518201
01364,北海道,乙部町,乙部町,3905,4408,-503,-11.4110707804,162.59,24.0,1730,1863,-133,-7.1390230811
01367,北海道,奥尻町,奥尻町,2693,3033,-340,-11.2100230795,142.97,18.8,1274,1364,-90,-6.5982404692
01370,北海道,今金町,今金町,5631,6186,-555,-8.9718719690,568.25,9.9,2280,2388,-108,-4.5226130653
01371,北海道,せたな町,せたな町,8471,9590,-1119,-11.6684045881,638.66,13.3,3850,4169,-319,-7.6517150396
01390,北海道,後志総合振興局,後志総合振興局,93626,101012,-7386,-7.3120025344,4062.05,23.0,42536,44120,-1584,-3.5902085222
01391,北海道,島牧村,島牧村,1495,1781,-286,-16.0583941606,437.18,3.4,658,742,-84,-11.3207547170
01392,北海道,寿都町,寿都町,3136,3443,-307,-8.9166424630,95.24,32.9,1427,1536,-109,-7.0963541667
01393,北海道,黒松内町,黒松内町,3082,3250,-168,-5.1692307692,345.65,8.9,1338,1353,-15,-1.1086474501
01394,北海道,蘭越町,蘭越町,4843,5292,-449,-8.4845049131,449.78,10.8,2093,2129,-36,-1.6909347111
01395,北海道,ニセコ町,ニセコ町,4962,4823,139,2.8820236367,197.13,25.2,2270,2054,216,10.5160662123
01396,北海道,真狩村,真狩村,2108,2189,-81,-3.7003197807,114.25,18.5,851,867,-16,-1.8454440600
01397,北海道,留寿都村,留寿都村,1905,2034,-129,-6.3421828909,119.84,15.9,915,883,32,3.6240090600
01398,北海道,喜茂別町,喜茂別町,2291,2490,-199,-7.9919678715,189.41,12.1,1130,1207,-77,-6.3794531897
01399,北海道,京極町,京極町,3187,3811,-624,-16.3736552086,231.49,13.8,1281,1740,-459,-26.3793103448
01400,北海道,倶知安町,倶知安町,15024,15568,-544,-3.4943473792,261.34,57.5,6971,7102,-131,-1.8445508308
01401,北海道,共和町,共和町,6233,6428,-195,-3.0336029869,304.91,20.4,2854,2698,156,5.7820607858
01402,北海道,岩内町,岩内町,13041,14451,-1410,-9.7571102346,70.60,184.7,6239,6555,-316,-4.8207475210
01403,北海道,泊村,泊村,1763,1883,-120,-6.3728093468,82.28,21.4,887,855,32,3.7426900585
01404,北海道,神恵内村,神恵内村,1004,1122,-118,-10.5169340463,147.80,6.8,434,473,-39,-8.2452431290
01405,北海道,積丹町,積丹町,2113,2516,-403,-16.0174880763,238.14,8.9,1000,1175,-175,-14.8936170213
01406,北海道,古平町,古平町,3188,3611,-423,-11.7142065910,188.36,16.9,1463,1588,-125,-7.8715365239
01407,北海道,仁木町,仁木町,3498,3800,-302,-7.9473684211,167.96,20.8,1480,1493,-13,-0.8707300737
01408,北海道,余市町,余市町,19631,21258,-1627,-7.6535892370,140.59,139.6,8711,9051,-340,-3.7564909955
01409,北海道,赤井川村,赤井川村,1122,1262,-140,-11.0935023772,280.09,4.0,534,619,-85,-13.7318255250
01420,北海道,空知総合振興局,空知総合振興局,72770,79345,-6575,-8.2865965089,2192.42,33.2,29094,30552,-1458,-4.7721916732
01423,北海道,南幌町,南幌町,7930,8778,-848,-9.6605149237,81.36,97.5,2968,3068,-100,-3.2594524120
01424,北海道,奈井江町,奈井江町,5678,6194,-516,-8.3306425573,88.19,64.4,2466,2622,-156,-5.9496567506
01425,北海道,上砂川町,上砂川町,3490,4086,-596,-14.5863925600,39.98,87.3,1744,1954,-210,-10.7471852610
01427,北海道,由仁町,由仁町,5316,5896,-580,-9.8371777476,133.74,39.7,2140,2258,-118,-5.2258635961
01428,北海道,長沼町,長沼町,11088,11691,-603,-5.1578137028,168.52,65.8,4246,4324,-78,-1.8038852914
01429,北海道,栗山町,栗山町,12354,13340,-986,-7.3913043478,203.93,60.6,5187,5484,-297,-5.4157549234
01430,北海道,月形町,月形町,4578,4859,-281,-5.7830829389,150.40,30.4,1467,1511,-44,-2.9119788220
01431,北海道,浦臼町,浦臼町,1985,2206,-221,-10.0181323663,101.83,19.5,877,920,-43,-4.6739130435
01432,北海道,新十津川町,新十津川町,6840,7249,-409,-5.6421575390,495.47,13.8,2579,2694,-115,-4.2687453601
01433,北海道,妹背牛町,妹背牛町,3083,3462,-379,-10.9474292317,48.64,63.4,1287,1356,-69,-5.0884955752
01434,北海道,秩父別町,秩父別町,2516,2730,-214,-7.8388278388,47.18,53.3,1017,1052,-35,-3.3269961977
01436,北海道,雨竜町,雨竜町,2748,3049,-301,-9.8720892096,191.15,14.4,1004,1067,-63,-5.9044048735
01437,北海道,北竜町,北竜町,1981,2193,-212,-9.6671226630,158.70,12.5,782,805,-23,-2.8571428571
01438,北海道,沼田町,沼田町,3183,3612,-429,-11.8770764120,283.35,11.2,1330,1437,-107,-7.4460681976
01450,北海道,上川総合振興局,上川総合振興局,91972,96633,-4661,-4.8234040131,7615.91,12.1,38320,38748,-428,-1.1045731393
01452,北海道,鷹栖町,鷹栖町,7016,7345,-329,-4.4792375766,139.42,50.3,2713,2732,-19,-0.6954612006
01453,北海道,東神楽町,東神楽町,10231,9292,939,10.1054670684,68.50,149.4,3656,3290,366,11.1246200608
01454,北海道,当麻町,当麻町,6692,7087,-395,-5.5735854381,204.90,32.7,2697,2743,-46,-1.6769959898
01455,北海道,比布町,比布町,3781,4042,-261,-6.4571994062,86.90,43.5,1586,1639,-53,-3.2336790726
01456,北海道,愛別町,愛別町,2979,3328,-349,-10.4867788462,250.13,11.9,1292,1332,-40,-3.0030030030
01457,北海道,上川町,上川町,4052,4532,-480,-10.5913503972,1049.47,3.9,2103,2303,-200,-8.6843247937
01458,北海道,東川町,東川町,8115,7859,256,3.2574118845,247.30,32.8,3149,2983,166,5.5648675830
01459,北海道,美瑛町,美瑛町,10297,10956,-659,-6.0149689668,676.78,15.2,4305,4301,4,0.0930016275
01460,北海道,上富良野町,上富良野町,10814,11545,-731,-6.3317453443,237.10,45.6,4363,4416,-53,-1.2001811594
01461,北海道,中富良野町,中富良野町,5071,5477,-406,-7.4128172357,108.65,46.7,2020,2015,5,0.2481389578
01462,北海道,南富良野町,南富良野町,2555,2814,-259,-9.2039800995,665.54,3.8,1132,1199,-67,-5.5879899917
01463,北海道,占冠村,占冠村,1211,1394,-183,-13.1276901004,571.41,2.1,709,794,-85,-10.7052896725
01464,北海道,和寒町,和寒町,3599,3832,-233,-6.0803757829,225.11,16.0,1526,1601,-75,-4.6845721424
01465,北海道,剣淵町,剣淵町,3235,3565,-330,-9.2566619916,130.99,24.7,1332,1329,3,0.2257336343
01468,北海道,下川町,下川町,3547,3775,-228,-6.0397350993,644.20,5.5,1672,1685,-13,-0.7715133531
01469,北海道,美深町,美深町,4659,5178,-519,-10.0231749710,672.09,6.9,2041,2194,-153,-6.9735642662
01470,北海道,音威子府村,音威子府村,832,995,-163,-16.3819095477,275.63,3.0,411,486,-75,-15.4320987654
01471,北海道,中川町,中川町,1763,1907,-144,-7.5511274253,594.74,3.0,898,926,-28,-3.0237580994
01472,北海道,幌加内町,幌加内町,1523,1710,-187,-10.9356725146,767.04,2.0,715,780,-65,-8.3333333333
01480,北海道,留萌振興局,留萌振興局,25695,28648,-2953,-10.3078748953,3148.05,8.2,11535,12276,-741,-6.0361681329
01481,北海道,増毛町,増毛町,4504,5078,-574,-11.3036628594,369.71,12.2,2052,2208,-156,-7.0652173913
01482,北海道,小平町,小平町,3339,3717,-378,-10.1694915254,627.22,5.3,1420,1512,-92,-6.0846560847
01483,北海道,苫前町,苫前町,3266,3656,-390,-10.6673960613,454.60,7.2,1421,1520,-99,-6.5131578947
01484,北海道,羽幌町,羽幌町,7321,7964,-643,-8.0738322451,472.65,15.5,3367,3534,-167,-4.7255234861
01485,北海道,初山別村,初山別村,1218,1369,-151,-11.0299488678,279.51,4.4,545,579,-34,-5.8721934370
01486,北海道,遠別町,遠別町,2807,3084,-277,-8.9818417639,590.80,4.8,1220,1304,-84,-6.4417177914
01487,北海道,天塩町,天塩町,3240,3780,-540,-14.2857142857,353.56,9.2,1510,1619,-109,-6.7325509574
01510,北海道,宗谷総合振興局,宗谷総合振興局,31121,33852,-2731,-8.0674701642,3864.60,8.1,14262,15056,-794,-5.2736450584
01511,北海道,猿払村,猿払村,2683,2825,-142,-5.0265486726,589.97,4.5,1174,1220,-46,-3.7704918033
01512,北海道,浜頓別町,浜頓別町,3880,4168,-288,-6.9097888676,401.64,9.7,1850,1868,-18,-0.9635974304
01513,北海道,中頓別町,中頓別町,1752,1974,-222,-11.2462006079,398.51,4.4,782,817,-35,-4.2839657283
01514,北海道,枝幸町,枝幸町,8440,9125,-685,-7.5068493151,1115.93,7.6,3772,3952,-180,-4.5546558704
01516,北海道,豊富町,豊富町,4054,4378,-324,-7.4006395614,520.69,7.8,1776,1854,-78,-4.2071197411
01517,北海道,礼文町,礼文町,2776,3078,-302,-9.8115659519,81.64,34.0,1339,1445,-106,-7.3356401384
01518,北海道,利尻町,利尻町,2303,2590,-287,-11.0810810811,76.51,30.1,1153,1313,-160,-12.1858339680
01519,北海道,利尻富士町,利尻富士町,2788,3037,-249,-8.1988804742,105.61,26.4,1267,1363,-96,-7.0432868672
01520,北海道,幌延町,幌延町,2445,2677,-232,-8.6664176317,574.10,4.3,1149,1224,-75,-6.1274509804
01540,北海道,オホーツク総合振興局,オホーツク総合振興局,110114,118572,-8458,-7.1332186351,7961.41,13.8,47314,49024,-1710,-3.4880874674
01543,北海道,美幌町,美幌町,20300,21575,-1275,-5.9096176130,438.41,46.3,8626,8725,-99,-1.1346704871
01544,北海道,津別町,津別町,5008,5646,-638,-11.3000354233,716.80,7.0,2231,2358,-127,-5.3859202714
01545,北海道,斜里町,斜里町,12226,13045,-819,-6.2782675355,737.12,16.6,5560,5759,-199,-3.4554610175
01546,北海道,清里町,清里町,4226,4551,-325,-7.1412876291,402.76,10.5,1671,1784,-113,-6.3340807175
01547,北海道,小清水町,小清水町,5086,5358,-272,-5.0765210900,286.89,17.7,2033,2069,-36,-1.7399710005
01549,北海道,訓子府町,訓子府町,5101,5435,-334,-6.1453541858,190.95,26.7,1910,1956,-46,-2.3517382413
01550,北海道,置戸町,置戸町,3092,3428,-336,-9.8016336056,527.27,5.9,1304,1367,-63,-4.6086320410
01552,北海道,佐呂間町,佐呂間町,5364,5892,-528,-8.9613034623,404.94,13.2,2312,2415,-103,-4.2650103520
01555,北海道,遠軽町,遠軽町,20864,22265,-1401,-6.2923871547,1332.45,15.7,9267,9617,-350,-3.6393885827
01559,北海道,湧別町,湧別町,9236,10041,-805,-8.0171297680,505.79,18.3,3861,4010,-149,-3.7157107232
01560,北海道,滝上町,滝上町,2719,3028,-309,-10.2047556143,766.89,3.5,1315,1376,-61,-4.4331395349
01561,北海道,興部町,興部町,3908,4301,-393,-9.1374099047,362.54,10.8,1784,1877,-93,-4.9547149707
01562,北海道,西興部村,西興部村,1118,1135,-17,-1.4977973568,308.08,3.6,501,516,-15,-2.9069767442
01563,北海道,雄武町,雄武町,4527,4939,-412,-8.3417695890,636.86,7.1,2066,2228,-162,-7.2710951526
01564,北海道,大空町,大空町,7339,7933,-594,-7.4877095676,343.66,21.4,2873,2967,-94,-3.1681833502
01570,北海道,胆振総合振興局,胆振総合振興局,55837,60630,-4793,-7.9053273957,2398.17,23.3,24929,25895,-966,-3.7304498938
01571,北海道,豊浦町,豊浦町,4298,4528,-230,-5.0795053004,233.57,18.4,2007,1944,63,3.2407407407
01575,北海道,壮瞥町,壮瞥町,2925,3232,-307,-9.4987623762,205.01,14.3,1172,1226,-54,-4.4045676998
01578,北海道,白老町,白老町,17744,19376,-1632,-8.4227910818,425.64,41.7,7956,8412,-456,-5.4208273894
01581,北海道,厚真町,厚真町,4825,4890,-65,-1.3292433538,404.61,11.9,2116,1972,144,7.3022312373
01584,北海道,洞爺湖町,洞爺湖町,9308,10132,-824,-8.1326490328,180.81,51.5,4237,4461,-224,-5.0212956736
01585,北海道,安平町,安平町,8144,8726,-582,-6.6697226679,237.16,34.3,3655,3753,-98,-2.6112443379
01586,北海道,むかわ町,むかわ町,8593,9746,-1153,-11.8304945619,711.36,12.1,3786,4127,-341,-8.2626605282
01600,北海道,日高振興局,日高振興局,69038,75321,-6283,-8.3416311520,4811.13,14.3,31126,32479,-1353,-4.1657686505
01601,北海道,日高町,日高町,12377,13615,-1238,-9.0929122292,992.11,12.5,5784,6064,-280,-4.6174142480
01602,北海道,平取町,平取町,5310,5596,-286,-5.1107934239,743.09,7.1,2369,2412,-43,-1.7827529022
01604,北海道,新冠町,新冠町,5596,5775,-179,-3.0995670996,585.81,9.6,2404,2388,16,0.6700167504
01607,北海道,浦河町,浦河町,13081,14389,-1308,-9.0902772952,694.26,18.8,6151,6358,-207,-3.2557407990
01608,北海道,様似町,様似町,4519,5114,-595,-11.6347281971,364.30,12.4,2046,2206,-160,-7.2529465095
01609,北海道,えりも町,えりも町,4905,5413,-508,-9.3848143359,284.00,17.3,1932,2036,-104,-5.1080550098
01610,北海道,新ひだか町,新ひだか町,23250,25419,-2169,-8.5329871356,1147.55,20.3,10440,11015,-575,-5.2201543350
01630,北海道,十勝総合振興局,十勝総合振興局,174132,180540,-6408,-3.5493519442,10212.28,17.1,72807,72681,126,0.1733603005
01631,北海道,音更町,音更町,44835,45085,-250,-0.5545081513,466.02,96.2,18020,17660,360,2.0385050963
01632,北海道,士幌町,士幌町,6135,6416,-281,-4.3796758105,259.19,23.7,2479,2458,21,0.8543531326
01633,北海道,上士幌町,上士幌町,4775,5080,-305,-6.0039370079,694.23,6.9,2178,2225,-47,-2.1123595506
01634,北海道,鹿追町,鹿追町,5542,5702,-160,-2.8060329709,402.88,13.8,2251,2270,-19,-0.8370044053
01635,北海道,新得町,新得町,6290,6653,-363,-5.4561851796,1063.83,5.9,3026,3106,-80,-2.5756600129
01636,北海道,清水町,清水町,9605,9961,-356,-3.5739383596,402.25,23.9,4118,4097,21,0.5125701733
01637,北海道,芽室町,芽室町,18478,18905,-427,-2.2586617297,513.76,36.0,7173,7089,84,1.1849344054
01638,北海道,中札内村,中札内村,3969,4006,-37,-0.9236145781,292.58,13.6,1609,1570,39,2.4840764331
01639,北海道,更別村,更別村,3186,3391,-205,-6.0454143321,176.90,18.0,1239,1274,-35,-2.7472527473
01641,北海道,大樹町,大樹町,5734,5977,-243,-4.0655847415,815.68,7.0,2536,2533,3,0.1184366364
01642,北海道,広尾町,広尾町,7032,7881,-849,-10.7727445756,596.54,11.8,3162,3294,-132,-4.0072859745
01643,北海道,幕別町,幕別町,26764,26547,217,0.8174181640,477.64,56.0,10936,10359,577,5.5700357177
01644,北海道,池田町,池田町,6886,7527,-641,-8.5160090341,371.79,18.5,3048,3189,-141,-4.4214487300
01645,北海道,豊頃町,豊頃町,3183,3394,-211,-6.2168532705,536.71,5.9,1362,1376,-14,-1.0174418605
01646,北海道,本別町,本別町,7343,8275,-932,-11.2628398792,391.91,18.7,3258,3482,-224,-6.4330844342
01647,北海道,足寄町,足寄町,6989,7630,-641,-8.4010484928,1408.04,5.0,3179,3348,-169,-5.0477897252
01648,北海道,陸別町,陸別町,2475,2650,-175,-6.6037735849,608.90,4.1,1147,1135,12,1.0572687225
01649,北海道,浦幌町,浦幌町,4911,5460,-549,-10.0549450549,729.85,6.7,2086,2216,-130,-5.8664259928
01660,北海道,釧路総合振興局,釧路総合振興局,61792,66151,-4359,-6.5894695469,4634.58,13.3,25990,26592,-602,-2.2638387485
01661,北海道,釧路町,釧路町,19833,20526,-693,-3.3762057878,252.66,78.5,8116,8098,18,0.2222771055
01662,北海道,厚岸町,厚岸町,9777,10630,-853,-8.0244590781,739.26,13.2,4115,4278,-163,-3.8101916784
01663,北海道,浜中町,浜中町,6064,6511,-447,-6.8653048687,423.63,14.3,2326,2344,-18,-0.7679180887
01664,北海道,標茶町,標茶町,7740,8285,-545,-6.5781532891,1099.37,7.0,3281,3365,-84,-2.4962852897
01665,北海道,弟子屈町,弟子屈町,7771,8278,-507,-6.1246677942,774.33,10.0,3507,3632,-125,-3.4416299559
01667,北海道,鶴居村,鶴居村,2536,2627,-91,-3.4640274077,571.80,4.4,1035,979,56,5.7201225741
01668,北海道,白糠町,白糠町,8071,9294,-1223,-13.1590273295,773.53,10.4,3610,3896,-286,-7.3408624230
01690,北海道,根室振興局,根室振興局,49721,51368,-1647,-3.2062762810,7994.12,16.1,20696,20358,338,1.6602809706
01691,北海道,別海町,別海町,15286,15855,-569,-3.5887732576,1319.63,11.6,5993,5862,131,2.2347321733
01692,北海道,中標津町,中標津町,23777,23982,-205,-0.8548077725,684.87,34.7,10433,10084,349,3.4609282031
01693,北海道,標津町,標津町,5243,5646,-403,-7.1377966702,624.68,8.4,2169,2235,-66,-2.9530201342
01694,北海道,羅臼町,羅臼町,5415,5885,-470,-7.9864061172,397.72,13.6,2101,2177,-76,-3.4910427193
02201,青森県,青森市,青森市,287622,299520,-11898,-3.9723557692,824.61,348.8,118279,119413,-1134,-0.9496453485
02202,青森県,弘前市,弘前市,177549,183473,-5924,-3.2288129589,524.20,338.7,71171,70142,1029,1.4670240370
02203,青森県,八戸市,八戸市,231379,237615,-6236,-2.6244134419,305.54,757.3,93726,91917,1809,1.9680798982
02204,青森県,黒石市,黒石市,34293,36132,-1839,-5.0896712056,217.05,158.0,11771,11794,-23,-0.1950144141
02205,青森県,五所川原市,五所川原市,55171,58421,-3250,-5.5630680748,404.18,136.5,21136,21277,-141,-0.6626874089
02206,青森県,十和田市,十和田市,63454,66110,-2656,-4.0175465134,725.65,87.4,25509,25554,-45,-0.1760976755
02207,青森県,三沢市,三沢市,40223,41258,-1035,-2.5086043919,119.87,335.6,16377,16211,166,1.0239960521
02208,青森県,むつ市,むつ市,58506,61066,-2560,-4.1921855042,864.16,67.7,24446,24775,-329,-1.3279515641
02209,青森県,つがる市,つがる市,33326,37243,-3917,-10.5174126682,253.55,131.4,10979,11473,-494,-4.3057613527
02210,青森県,平川市,平川市,32130,33764,-1634,-4.8394739960,346.01,92.9,10130,10063,67,0.6658054258
02300,青森県,東津軽郡,東津軽郡,22988,25938,-2950,-11.3732747321,653.29,35.2,8787,9436,-649,-6.8779143705
02301,青森県,平内町,平内町,11148,12361,-1213,-9.8131219157,217.09,51.4,3968,4198,-230,-5.4787994283
02303,青森県,今別町,今別町,2747,3217,-470,-14.6098849860,125.27,21.9,1289,1379,-90,-6.5264684554
02304,青森県,蓬田村,蓬田村,2896,3271,-375,-11.4643839804,80.65,35.9,957,1070,-113,-10.5607476636
02307,青森県,外ヶ浜町,外ヶ浜町,6197,7089,-892,-12.5828748766,230.29,26.9,2573,2789,-216,-7.7447113661
02320,青森県,西津軽郡,西津軽郡,18554,21140,-2586,-12.2327341533,831.96,22.3,7155,7627,-472,-6.1885407106
02321,青森県,鰺ヶ沢町,鰺ヶ沢町,10131,11449,-1318,-11.5119224386,343.08,29.5,3851,4095,-244,-5.9584859585
02323,青森県,深浦町,深浦町,8423,9691,-1268,-13.0843050253,488.89,17.2,3304,3532,-228,-6.4552661382
02340,青森県,中津軽郡,中津軽郡,1415,1594,-179,-11.2296110414,246.02,5.8,488,570,-82,-14.3859649123
02343,青森県,西目屋村,西目屋村,1415,1594,-179,-11.2296110414,246.02,5.8,488,570,-82,-14.3859649123
02360,青森県,南津軽郡,南津軽郡,32647,35152,-2505,-7.1261948111,223.06,146.4,10742,10966,-224,-2.0426773664
02361,青森県,藤崎町,藤崎町,15180,16021,-841,-5.2493602147,37.29,407.1,4941,4912,29,0.5903908795
02362,青森県,大鰐町,大鰐町,9684,10978,-1294,-11.7872107852,163.43,59.3,3419,3648,-229,-6.2774122807
02367,青森県,田舎館村,田舎館村,7783,8153,-370,-4.5382067950,22.35,348.2,2382,2406,-24,-0.9975062344
02380,青森県,北津軽郡,北津軽郡,38542,42240,-3698,-8.7547348485,304.64,126.5,13175,13542,-367,-2.7100871363
02381,青森県,板柳町,板柳町,13937,15227,-1290,-8.4717935247,41.88,332.8,4680,4770,-90,-1.8867924528
02384,青森県,鶴田町,鶴田町,13400,14270,-870,-6.0967063770,46.43,288.6,4384,4402,-18,-0.4089050432
02387,青森県,中泊町,中泊町,11205,12743,-1538,-12.0693714196,216.32,51.8,4111,4370,-259,-5.9267734554
02400,青森県,上北郡,上北郡,96924,100607,-3683,-3.6607790710,1280.32,75.7,35781,35758,23,0.0643212708
02401,青森県,野辺地町,野辺地町,13520,14314,-794,-5.5470169065,81.68,165.5,5542,5766,-224,-3.8848421783
02402,青森県,七戸町,七戸町,15719,16759,-1040,-6.2056208604,337.23,46.6,5585,5713,-128,-2.2405041134
02405,青森県,六戸町,六戸町,10423,10241,182,1.7771701982,83.89,124.2,3570,3307,263,7.9528273360
02406,青森県,横浜町,横浜町,4535,4881,-346,-7.0887113296,126.38,35.9,1786,1884,-98,-5.2016985138
02408,青森県,東北町,東北町,17969,19106,-1137,-5.9510101539,326.50,55.0,5980,6007,-27,-0.4494756118
02411,青森県,六ヶ所村,六ヶ所村,10538,11095,-557,-5.0202794051,252.68,41.7,4683,4751,-68,-1.4312776258
02412,青森県,おいらせ町,おいらせ町,24220,24211,9,0.0371731857,71.96,336.6,8635,8330,305,3.6614645858
02420,青森県,下北郡,下北郡,15953,18477,-2524,-13.6602262272,551.96,28.9,6474,7430,-956,-12.8667563930
02423,青森県,大間町,大間町,5220,6340,-1120,-17.6656151420,52.10,100.2,2161,2636,-475,-18.0197268589
02424,青森県,東通村,東通村,6604,7252,-648,-8.9354660783,295.27,22.4,2578,2710,-132,-4.8708487085
02425,青森県,風間浦村,風間浦村,1977,2463,-486,-19.7320341048,69.55,28.4,822,1096,-274,-25.0000000000
02426,青森県,佐井村,佐井村,2152,2422,-270,-11.1478117258,135.04,15.9,913,988,-75,-7.5910931174
02440,青森県,三戸郡,三戸郡,67973,73589,-5616,-7.6315753713,969.33,70.1,24822,25437,-615,-2.4177379408
02441,青森県,三戸町,三戸町,10150,11299,-1149,-10.1690415081,151.79,66.9,3758,3961,-203,-5.1249684423
02442,青森県,五戸町,五戸町,17433,18712,-1279,-6.8351859769,177.67,98.1,6126,6177,-51,-0.8256435163
02443,青森県,田子町,田子町,5553,6175,-622,-10.0728744939,241.98,22.9,2005,2097,-92,-4.3872198379
02445,青森県,南部町,南部町,18319,19853,-1534,-7.7267919206,153.12,119.6,6420,6621,-201,-3.0357951971
02446,青森県,階上町,階上町,14008,14699,-691,-4.7010000680,94.01,149.0,5682,5707,-25,-0.4380585246
02450,青森県,新郷村,新郷村,2510,2851,-341,-11.9607155384,150.77,16.6,831,874,-43,-4.9199084668
03201,岩手県,盛岡市,盛岡市,297669,298348,-679,-0.2275865767,886.47,335.8,128848,125096,3752,2.9992965403
03202,岩手県,宮古市,宮古市,56569,59430,-2861,-4.8140669695,1259.15,44.9,23365,22509,856,3.8029232751
03203,岩手県,大船渡市,大船渡市,38068,40737,-2669,-6.5517833910,322.50,118.0,14811,14819,-8,-0.0539847493
03205,岩手県,花巻市,花巻市,97771,101438,-3667,-3.6150160689,908.39,107.6,33833,33774,59,0.1746905904
03206,岩手県,北上市,北上市,93591,93138,453,0.4863750564,437.55,213.9,35812,34068,1744,5.1191734179
03207,岩手県,久慈市,久慈市,35644,36872,-1228,-3.3304404426,623.50,57.2,14182,14012,170,1.2132457893
03208,岩手県,遠野市,遠野市,28071,29331,-1260,-4.2957962565,825.97,34.0,9961,9888,73,0.7382686084
03209,岩手県,一関市,一関市,121625,127642,-6017,-4.7139656226,1256.42,96.8,43015,42633,382,0.8960195154
03210,岩手県,陸前高田市,陸前高田市,19757,23300,-3543,-15.2060085837,231.94,85.2,7487,7785,-298,-3.8278741169
03211,岩手県,釜石市,釜石市,36812,39574,-2762,-6.9793298630,440.34,83.6,16854,16094,760,4.7222567416
03213,岩手県,二戸市,二戸市,27637,29702,-2065,-6.9523937782,420.42,65.7,10672,10847,-175,-1.6133493132
03214,岩手県,八幡平市,八幡平市,26371,28680,-2309,-8.0509065551,862.30,30.6,9434,9664,-230,-2.3799668874
03215,岩手県,奥州市,奥州市,119465,124746,-5281,-4.2334022734,993.30,120.3,41725,41388,337,0.8142456751
03216,岩手県,滝沢市,滝沢市,55487,53857,1630,3.0265332269,182.46,304.1,20778,19400,1378,7.1030927835
03300,岩手県,岩手郡,岩手郡,37006,40321,-3315,-8.2215222837,1404.24,26.4,12870,13246,-376,-2.8385927827
03301,岩手県,雫石町,雫石町,16967,18033,-1066,-5.9113846836,608.82,27.9,5486,5543,-57,-1.0283240123
03302,岩手県,葛巻町,葛巻町,6340,7304,-964,-13.1982475356,434.96,14.6,2461,2664,-203,-7.6201201201
03303,岩手県,岩手町,岩手町,13699,14984,-1285,-8.5758142018,360.46,38.0,4923,5039,-116,-2.3020440564
03320,岩手県,紫波郡,紫波郡,60309,60493,-184,-0.3041674243,306.30,196.9,20642,19369,1273,6.5723578915
03321,岩手県,紫波町,紫波町,32626,33288,-662,-1.9887046383,238.98,136.5,10808,10513,295,2.8060496528
03322,岩手県,矢巾町,矢巾町,27683,27205,478,1.7570299577,67.32,411.2,9834,8856,978,11.0433604336
03360,岩手県,和賀郡,和賀郡,5880,6602,-722,-10.9360799758,590.74,10.0,2146,2272,-126,-5.5457746479
03366,岩手県,西和賀町,西和賀町,5880,6602,-722,-10.9360799758,590.74,10.0,2146,2272,-126,-5.5457746479
03380,岩手県,胆沢郡,胆沢郡,15909,16325,-416,-2.5482388974,179.76,88.5,5624,5409,215,3.9748567203
03381,岩手県,金ケ崎町,金ケ崎町,15909,16325,-416,-2.5482388974,179.76,88.5,5624,5409,215,3.9748567203
03400,岩手県,西磐井郡,西磐井郡,7869,8345,-476,-5.7040143799,63.39,124.1,2478,2454,24,0.9779951100
03402,岩手県,平泉町,平泉町,7869,8345,-476,-5.7040143799,63.39,124.1,2478,2454,24,0.9779951100
03440,岩手県,気仙郡,気仙郡,5723,6190,-467,-7.5444264943,334.84,17.1,2119,2083,36,1.7282765242
03441,岩手県,住田町,住田町,5723,6190,-467,-7.5444264943,334.84,17.1,2119,2083,36,1.7282765242
03460,岩手県,上閉伊郡,上閉伊郡,11732,15276,-3544,-23.1997905211,200.42,58.5,4571,5689,-1118,-19.6519599227
03461,岩手県,大槌町,大槌町,11732,15276,-3544,-23.1997905211,200.42,58.5,4571,5689,-1118,-19.6519599227
03480,岩手県,下閉伊郡,下閉伊郡,31922,36352,-4430,-12.1863996479,1481.02,21.6,12828,13313,-485,-3.6430556599
03482,岩手県,山田町,山田町,15826,18617,-2791,-14.9916742762,262.81,60.2,6265,6605,-340,-5.1476154428
03483,岩手県,岩泉町,岩泉町,9839,10804,-965,-8.9318770826,992.36,9.9,4174,4357,-183,-4.2001377094
03484,岩手県,田野畑村,田野畑村,3461,3843,-382,-9.9401509238,156.19,22.2,1291,1309,-18,-1.3750954927
03485,岩手県,普代村,普代村,2796,3088,-292,-9.4559585492,69.66,40.1,1098,1042,56,5.3742802303
03500,岩手県,九戸郡,九戸郡,36015,39261,-3246,-8.2677466188,763.55,47.2,12781,13075,-294,-2.2485659656
03501,岩手県,軽米町,軽米町,9333,10209,-876,-8.5806641199,245.82,38.0,3318,3343,-25,-0.7478312893
03503,岩手県,野田村,野田村,4127,4632,-505,-10.9024179620,80.80,51.1,1529,1578,-49,-3.1051964512
03506,岩手県,九戸村,九戸村,5861,6507,-646,-9.9277700937,134.02,43.7,1986,2034,-48,-2.3598820059
03507,岩手県,洋野町,洋野町,16694,17913,-1219,-6.8051136046,302.92,55.1,5948,6120,-172,-2.8104575163
03520,岩手県,二戸郡,二戸郡,12912,14187,-1275,-8.9871008670,300.03,43.0,4889,5047,-158,-3.1305726174
03524,岩手県,一戸町,一戸町,12912,14187,-1275,-8.9871008670,300.03,43.0,4889,5047,-158,-3.1305726174
04101,宮城県,仙台市青葉区,仙台市 青葉区,310181,291436,18745,6.4319438916,302.24,1026.3,158458,144125,14333,9.9448395490
04102,宮城県,仙台市宮城野区,仙台市 宮城野区,194930,190473,4457,2.3399641944,58.19,3349.9,90082,85925,4157,4.8379400640
04103,宮城県,仙台市若林区,仙台市 若林区,133419,132306,1113,0.8412316902,50.86,2623.3,61885,58914,2971,5.0429439522
04104,宮城県,仙台市太白区,仙台市 太白区,226687,220588,6099,2.7648829492,228.39,992.5,98539,91526,7013,7.6623036077
04105,宮城県,仙台市泉区,仙台市 泉区,216968,211183,5785,2.7393303438,146.61,1479.9,90126,84770,5356,6.3182729739
04202,宮城県,石巻市,石巻市,147236,160826,-13590,-8.4501262234,554.50,265.5,56739,57871,-1132,-1.9560747179
04203,宮城県,塩竈市,塩竈市,54195,56490,-2295,-4.0626659586,17.37,3120.0,20547,20396,151,0.7403412434
04205,宮城県,気仙沼市,気仙沼市,64917,73489,-8572,-11.6643307162,332.44,195.3,24139,25457,-1318,-5.1773578976
04206,宮城県,白石市,白石市,35274,37422,-2148,-5.7399390733,286.48,123.1,12560,12532,28,0.2234280243
04207,宮城県,名取市,名取市,76719,73134,3585,4.9019607843,98.17,781.5,27517,25124,2393,9.5247572043
04208,宮城県,角田市,角田市,30193,31336,-1143,-3.6475619096,147.53,204.7,10398,10082,316,3.1342987502
04209,宮城県,多賀城市,多賀城市,62128,63060,-932,-1.4779575008,19.69,3155.3,24074,24079,-5,-0.0207649819
04211,宮城県,岩沼市,岩沼市,44704,44187,517,1.1700273836,60.45,739.5,16593,15519,1074,6.9205490044
04212,宮城県,登米市,登米市,81989,83969,-1980,-2.3580130763,536.12,152.9,26234,25002,1232,4.9276057915
04213,宮城県,栗原市,栗原市,69906,74932,-5026,-6.7074147227,804.97,86.8,23192,23407,-215,-0.9185286453
04214,宮城県,東松島市,東松島市,39518,42903,-3385,-7.8898911498,101.36,389.9,13854,14013,-159,-1.1346606722
04215,宮城県,大崎市,大崎市,133430,135147,-1717,-1.2704684529,796.80,167.5,48316,46146,2170,4.7024660859
04300,宮城県,刈田郡,刈田郡,13782,14576,-794,-5.4473106476,415.92,33.1,4480,4512,-32,-0.7092198582
04301,宮城県,蔵王町,蔵王町,12324,12882,-558,-4.3316255240,152.83,80.6,3913,3890,23,0.5912596401
04302,宮城県,七ヶ宿町,七ヶ宿町,1458,1694,-236,-13.9315230224,263.09,5.5,567,622,-55,-8.8424437299
04320,宮城県,柴田郡,柴田郡,84005,84844,-839,-0.9888736976,428.17,196.2,30853,29648,1205,4.0643550998
04321,宮城県,大河原町,大河原町,23800,23530,270,1.1474713132,24.99,952.4,9101,8641,460,5.3234579331
04322,宮城県,村田町,村田町,11505,11995,-490,-4.0850354314,78.38,146.8,3761,3630,131,3.6088154270
04323,宮城県,柴田町,柴田町,39533,39341,192,0.4880404667,54.03,731.7,15113,14490,623,4.2995169082
04324,宮城県,川崎町,川崎町,9167,9978,-811,-8.1278813389,270.77,33.9,2878,2887,-9,-0.3117422930
04340,宮城県,伊具郡,伊具郡,13984,15501,-1517,-9.7864653893,273.30,51.2,4551,4649,-98,-2.1079802108
04341,宮城県,丸森町,丸森町,13984,15501,-1517,-9.7864653893,273.30,51.2,4551,4649,-98,-2.1079802108
04360,宮城県,亘理郡,亘理郡,45912,51549,-5637,-10.9352266775,138.18,332.3,15746,16138,-392,-2.4290494485
04361,宮城県,亘理町,亘理町,33598,34845,-1247,-3.5787056967,73.60,456.5,11321,10903,418,3.8338072090
04362,宮城県,山元町,山元町,12314,16704,-4390,-26.2811302682,64.58,190.7,4425,5235,-810,-15.4727793696
04400,宮城県,宮城郡,宮城郡,68956,69495,-539,-0.7755953666,111.64,617.7,23456,22370,1086,4.8547161377
04401,宮城県,松島町,松島町,14424,15085,-661,-4.3818362612,53.56,269.3,5105,5137,-32,-0.6229316722
04404,宮城県,七ヶ浜町,七ヶ浜町,18651,20416,-1765,-8.6451802508,13.19,1414.0,6167,6415,-248,-3.8659392050
04406,宮城県,利府町,利府町,35881,33994,1887,5.5509795846,44.89,799.3,12184,10818,1366,12.6271029765
04420,宮城県,黒川郡,黒川郡,93920,86197,7723,8.9597085745,417.00,225.2,31857,27368,4489,16.4023677287
04421,宮城県,大和町,大和町,28252,24894,3358,13.4891941833,225.49,125.3,10170,8056,2114,26.2413108242
04422,宮城県,大郷町,大郷町,8371,8927,-556,-6.2282961801,82.01,102.1,2421,2423,-2,-0.0825423029
04423,宮城県,富谷町,富谷町,51592,47042,4550,9.6722078143,49.18,1049.0,17488,15399,2089,13.5658159621
04424,宮城県,大衡村,大衡村,5705,5334,371,6.9553805774,60.32,94.6,1778,1490,288,19.3288590604
04440,宮城県,加美郡,加美郡,30981,32958,-1977,-5.9985436009,569.94,54.4,9534,9520,14,0.1470588235
04444,宮城県,色麻町,色麻町,7240,7431,-191,-2.5703135513,109.28,66.3,1973,1923,50,2.6001040042
04445,宮城県,加美町,加美町,23741,25527,-1786,-6.9965134955,460.67,51.5,7561,7597,-36,-0.4738712650
04500,宮城県,遠田郡,遠田郡,41572,42684,-1112,-2.6051916409,157.06,264.7,13798,13506,292,2.1620020732
04501,宮城県,涌谷町,涌谷町,16707,17494,-787,-4.4986852635,82.16,203.3,5474,5496,-22,-0.4002911208
04505,宮城県,美里町,美里町,24865,25190,-325,-1.2901945216,74.90,332.0,8324,8010,314,3.9200998752
04580,宮城県,牡鹿郡,牡鹿郡,6334,10051,-3717,-36.9813948861,65.35,96.9,3154,3968,-814,-20.5141129032
04581,宮城県,女川町,女川町,6334,10051,-3717,-36.9813948861,65.35,96.9,3154,3968,-814,-20.5141129032
04600,宮城県,本吉郡,本吉郡,12375,17429,-5054,-28.9976475988,163.40,75.7,4037,5295,-1258,-23.7582625118
04606,宮城県,南三陸町,南三陸町,12375,17429,-5054,-28.9976475988,163.40,75.7,4037,5295,-1258,-23.7582625118
05201,秋田県,秋田市,秋田市,315374,323600,-8226,-2.5420271941,906.09,348.1,135369,131318,4051,3.0848779299
05202,秋田県,能代市,能代市,54746,59084,-4338,-7.3420892289,426.95,128.2,22373,22806,-433,-1.8986231693
05203,秋田県,横手市,横手市,92214,98367,-6153,-6.2551465430,692.80,133.1,31493,31807,-314,-0.9872040746
05204,秋田県,大館市,大館市,74153,78946,-4793,-6.0712385681,913.22,81.2,28260,28565,-305,-1.0677402416
05206,秋田県,男鹿市,男鹿市,28395,32294,-3899,-12.0734501765,241.09,117.8,11143,11625,-482,-4.1462365591
05207,秋田県,湯沢市,湯沢市,46620,50849,-4229,-8.3167810576,790.91,58.9,16363,16855,-492,-2.9190151290
05209,秋田県,鹿角市,鹿角市,32057,34473,-2416,-7.0083833725,707.52,45.3,11509,11863,-354,-2.9840681109
05210,秋田県,由利本荘市,由利本荘市,79993,85229,-5236,-6.1434488261,1209.60,66.1,28347,28648,-301,-1.0506841664
05211,秋田県,潟上市,潟上市,33098,34442,-1344,-3.9022124151,97.73,338.7,12023,11936,87,0.7288873995
05212,秋田県,大仙市,大仙市,82773,88301,-5528,-6.2604047519,866.77,95.5,28195,28354,-159,-0.5607674402
05213,秋田県,北秋田市,北秋田市,33230,36387,-3157,-8.6761755572,1152.76,28.8,12223,12837,-614,-4.7830489990
05214,秋田県,にかほ市,にかほ市,25330,27544,-2214,-8.0380482138,241.13,105.0,8804,9203,-399,-4.3355427578
05215,秋田県,仙北市,仙北市,27530,29568,-2038,-6.8925865801,1093.56,25.2,9585,9859,-274,-2.7791865301
05300,秋田県,鹿角郡,鹿角郡,5342,6054,-712,-11.7608192930,201.70,26.5,2168,2390,-222,-9.2887029289
05303,秋田県,小坂町,小坂町,5342,6054,-712,-11.7608192930,201.70,26.5,2168,2390,-222,-9.2887029289
05320,秋田県,北秋田郡,北秋田郡,2375,2727,-352,-12.9079574624,256.72,9.3,919,1008,-89,-8.8293650794
05327,秋田県,上小阿仁村,上小阿仁村,2375,2727,-352,-12.9079574624,256.72,9.3,919,1008,-89,-8.8293650794
05340,秋田県,山本郡,山本郡,27742,30944,-3202,-10.3477249224,764.26,36.3,9929,10486,-557,-5.3118443639
05346,秋田県,藤里町,藤里町,3360,3848,-488,-12.6819126819,282.13,11.9,1215,1322,-107,-8.0937972769
05348,秋田県,三種町,三種町,17077,18876,-1799,-9.5306208943,247.98,68.9,6008,6294,-286,-4.5440101684
05349,秋田県,八峰町,八峰町,7305,8220,-915,-11.1313868613,234.14,31.2,2706,2870,-164,-5.7142857143
05360,秋田県,南秋田郡,南秋田郡,23655,25850,-2195,-8.4912959381,449.97,52.6,8150,8444,-294,-3.4817621980
05361,秋田県,五城目町,五城目町,9481,10516,-1035,-9.8421453024,214.92,44.1,3574,3733,-159,-4.2593088669
05363,秋田県,八郎潟町,八郎潟町,6079,6623,-544,-8.2138003926,17.00,357.6,2216,2303,-87,-3.7776812853
05366,秋田県,井川町,井川町,4987,5493,-506,-9.2117240124,47.95,104.0,1563,1604,-41,-2.5561097257
05368,秋田県,大潟村,大潟村,3108,3218,-110,-3.4182722188,170.11,18.3,797,804,-7,-0.8706467662
05420,秋田県,仙北郡,仙北郡,20280,21674,-1394,-6.4316692812,168.34,120.5,6152,6291,-139,-2.2095056430
05434,秋田県,美郷町,美郷町,20280,21674,-1394,-6.4316692812,168.34,120.5,6152,6291,-139,-2.2095056430
05460,秋田県,雄勝郡,雄勝郡,17932,19664,-1732,-8.8079739626,434.46,41.3,5616,5841,-225,-3.8520801233
05463,秋田県,羽後町,羽後町,15321,16792,-1471,-8.7601238685,230.78,66.4,4807,4966,-159,-3.2017720499
05464,秋田県,東成瀬村,東成瀬村,2611,2872,-261,-9.0877437326,203.69,12.8,809,875,-66,-7.5428571429
06201,山形県,山形市,山形市,252453,254244,-1791,-0.7044414027,381.30,662.1,100669,96560,4109,4.2553852527
06202,山形県,米沢市,米沢市,86010,89401,-3391,-3.7930224494,548.51,156.8,32991,33013,-22,-0.0666404144
06203,山形県,鶴岡市,鶴岡市,129630,136623,-6993,-5.1184646802,1311.53,98.8,45332,45514,-182,-0.3998769609
06204,山形県,酒田市,酒田市,106267,111151,-4884,-4.3940225459,602.97,176.2,39308,38955,353,0.9061737903
06205,山形県,新庄市,新庄市,36904,38850,-1946,-5.0090090090,222.85,165.6,12976,12980,-4,-0.0308166410
06206,山形県,寒河江市,寒河江市,41266,42373,-1107,-2.6125126850,139.03,296.8,13073,12717,356,2.7994023748
06207,山形県,上山市,上山市,31584,33836,-2252,-6.6556330536,240.93,131.1,10724,10751,-27,-0.2511394289
06208,山形県,村山市,村山市,24696,26811,-2115,-7.8885532058,196.98,125.4,7712,7865,-153,-1.9453273999
06209,山形県,長井市,長井市,27716,29473,-1757,-5.9613883894,214.67,129.1,9114,9269,-155,-1.6722408027
06210,山形県,天童市,天童市,62236,62214,22,0.0353618157,113.01,550.7,21448,20404,1044,5.1166437953
06211,山形県,東根市,東根市,47865,46414,1451,3.1262119188,206.94,231.3,15487,14388,1099,7.6383097025
06212,山形県,尾花沢市,尾花沢市,16962,18955,-1993,-10.5143761540,372.53,45.5,5109,5332,-223,-4.1822955739
06213,山形県,南陽市,南陽市,32284,33658,-1374,-4.0822389922,160.52,201.1,10697,10567,130,1.2302451027
06300,山形県,東村山郡,東村山郡,25738,27154,-1416,-5.2147013331,92.60,277.9,7904,7842,62,0.7906146391
06301,山形県,山辺町,山辺町,14372,15139,-767,-5.0663848339,61.45,233.9,4438,4419,19,0.4299615298
06302,山形県,中山町,中山町,11366,12015,-649,-5.4015813566,31.15,364.9,3466,3423,43,1.2562080047
06320,山形県,西村山郡,西村山郡,40286,43312,-3026,-6.9865164389,796.53,50.6,12521,12595,-74,-0.5875347360
06321,山形県,河北町,河北町,19046,19959,-913,-4.5743774738,52.45,363.1,5868,5740,128,2.2299651568
06322,山形県,西川町,西川町,5640,6270,-630,-10.0478468900,393.19,14.3,1779,1853,-74,-3.9935240151
06323,山形県,朝日町,朝日町,7122,7856,-734,-9.3431771894,196.81,36.2,2243,2311,-68,-2.9424491562
06324,山形県,大江町,大江町,8478,9227,-749,-8.1174813049,154.08,55.0,2631,2691,-60,-2.2296544036
06340,山形県,北村山郡,北村山郡,7359,8160,-801,-9.8161764706,79.54,92.5,2143,2227,-84,-3.7718904356
06341,山形県,大石田町,大石田町,7359,8160,-801,-9.8161764706,79.54,92.5,2143,2227,-84,-3.7718904356
06360,山形県,最上郡,最上郡,41005,45469,-4464,-9.8176779784,1580.38,25.9,12109,12546,-437,-3.4831818906
06361,山形県,金山町,金山町,5829,6365,-536,-8.4210526316,161.67,36.1,1643,1703,-60,-3.5231943629
06362,山形県,最上町,最上町,8908,9847,-939,-9.5358992587,330.37,27.0,2674,2764,-90,-3.2561505065
06363,山形県,舟形町,舟形町,5631,6164,-533,-8.6469824789,119.04,47.3,1620,1652,-32,-1.9370460048
06364,山形県,真室川町,真室川町,8136,9165,-1029,-11.2274959083,374.22,21.7,2520,2631,-111,-4.2189281642
06365,山形県,大蔵村,大蔵村,3413,3762,-349,-9.2769803296,211.63,16.1,1017,1045,-28,-2.6794258373
06366,山形県,鮭川村,鮭川村,4315,4862,-547,-11.2505141917,122.14,35.3,1246,1300,-54,-4.1538461538
06367,山形県,戸沢村,戸沢村,4773,5304,-531,-10.0113122172,261.31,18.3,1389,1451,-62,-4.2729152309
06380,山形県,東置賜郡,東置賜郡,39643,42338,-2695,-6.3654400302,346.86,114.3,11765,11951,-186,-1.5563551167
06381,山形県,高畠町,高畠町,23887,25025,-1138,-4.5474525475,180.26,132.5,7215,7241,-26,-0.3590664273
06382,山形県,川西町,川西町,15756,17313,-1557,-8.9932420724,166.60,94.6,4550,4710,-160,-3.3970276008
06400,山形県,西置賜郡,西置賜郡,29444,32119,-2675,-8.3284037486,1224.68,24.0,9471,9736,-265,-2.7218570255
06401,山形県,小国町,小国町,7869,8862,-993,-11.2051455653,737.56,10.7,2841,3036,-195,-6.4229249012
06402,山形県,白鷹町,白鷹町,14271,15314,-1043,-6.8107613948,157.71,90.5,4433,4465,-32,-0.7166853303
06403,山形県,飯豊町,飯豊町,7304,7943,-639,-8.0448193378,329.41,22.2,2197,2235,-38,-1.7002237136
06420,山形県,東田川郡,東田川郡,29397,30889,-1492,-4.8301984525,282.39,104.1,8857,8788,69,0.7851615840
06426,山形県,三川町,三川町,7728,7731,-3,-0.0388048118,33.22,232.6,2219,2140,79,3.6915887850
06428,山形県,庄内町,庄内町,21669,23158,-1489,-6.4297435012,249.17,87.0,6638,6648,-10,-0.1504211793
06460,山形県,飽海郡,飽海郡,14212,15480,-1268,-8.1912144703,208.39,68.2,4510,4608,-98,-2.1267361111
06461,山形県,遊佐町,遊佐町,14212,15480,-1268,-8.1912144703,208.39,68.2,4510,4608,-98,-2.1267361111
07201,福島県,福島市,福島市,294378,292590,1788,0.6110940224,767.72,383.4,122229,113074,9155,8.0964677998
07202,福島県,会津若松市,会津若松市,124085,126220,-2135,-1.6914910474,382.97,324.0,49305,47891,1414,2.9525380552
07203,福島県,郡山市,郡山市,335608,338712,-3104,-0.9164127636,757.20,443.2,138124,131740,6384,4.8459086079
07204,福島県,いわき市,いわき市,349344,342249,7095,2.0730520761,1232.02,283.6,140837,128722,12115,9.4117555663
07205,福島県,白河市,白河市,61914,64704,-2790,-4.3119436202,305.32,202.8,23012,22726,286,1.2584704743
07207,福島県,須賀川市,須賀川市,77458,79267,-1809,-2.2821602937,279.43,277.2,26343,25792,551,2.1363213400
07208,福島県,喜多方市,喜多方市,49421,52356,-2935,-5.6058522423,554.63,89.1,16755,16983,-228,-1.3425189896
07209,福島県,相馬市,相馬市,38575,37817,758,2.0043895603,197.80,195.0,14891,13227,1664,12.5803281167
07210,福島県,二本松市,二本松市,58164,59871,-1707,-2.8511299293,344.42,168.9,19778,18364,1414,7.6998475278
07211,福島県,田村市,田村市,38500,40422,-1922,-4.7548364752,458.33,84.0,12725,11933,792,6.6370569010
07212,福島県,南相馬市,南相馬市,57733,70878,-13145,-18.5459521996,398.58,144.8,25891,23640,2251,9.5219966159
07213,福島県,伊達市,伊達市,62436,66027,-3591,-5.4386841747,265.12,235.5,21656,20870,786,3.7661715381
07214,福島県,本宮市,本宮市,30924,31489,-565,-1.7942773667,88.02,351.3,10044,9538,506,5.3050954078
07300,福島県,伊達郡,伊達郡,36275,38508,-2233,-5.7987950556,208.62,173.9,13059,12438,621,4.9927641100
07301,福島県,桑折町,桑折町,12277,12853,-576,-4.4814440209,42.97,285.7,4269,4055,214,5.2774352651
07303,福島県,国見町,国見町,9519,10086,-567,-5.6216537775,37.95,250.8,3277,3204,73,2.2784019975
07308,福島県,川俣町,川俣町,14479,15569,-1090,-7.0010919134,127.70,113.4,5513,5179,334,6.4491214520
07320,福島県,安達郡,安達郡,8684,8574,110,1.2829484488,79.44,109.3,2614,2253,361,16.0230803373
07322,福島県,大玉村,大玉村,8684,8574,110,1.2829484488,79.44,109.3,2614,2253,361,16.0230803373
07340,福島県,岩瀬郡,岩瀬郡,18102,19106,-1004,-5.2548937507,256.82,70.5,5835,5745,90,1.5665796345
07342,福島県,鏡石町,鏡石町,12482,12815,-333,-2.5985173625,31.30,398.8,4196,4076,120,2.9440628067
07344,福島県,天栄村,天栄村,5620,6291,-671,-10.6660308377,225.52,24.9,1639,1669,-30,-1.7974835231
07360,福島県,南会津郡,南会津郡,27117,29893,-2776,-9.2864550229,2341.53,11.6,10226,10682,-456,-4.2688635087
07362,福島県,下郷町,下郷町,5786,6461,-675,-10.4472991797,317.04,18.3,2003,2103,-100,-4.7551117451
07364,福島県,檜枝岐村,檜枝岐村,614,636,-22,-3.4591194969,390.46,1.6,222,221,1,0.4524886878
07367,福島県,只見町,只見町,4470,4932,-462,-9.3673965937,747.56,6.0,1759,1851,-92,-4.9702863317
07368,福島県,南会津町,南会津町,16247,17864,-1617,-9.0517241379,886.47,18.3,6242,6507,-265,-4.0725372676
07400,福島県,耶麻郡,耶麻郡,28021,30117,-2096,-6.9595245210,986.88,28.4,9596,9790,-194,-1.9816138917
07402,福島県,北塩原村,北塩原村,2810,3185,-375,-11.7739403454,234.08,12.0,1008,1052,-44,-4.1825095057
07405,福島県,西会津町,西会津町,6583,7366,-783,-10.6299212598,298.18,22.1,2531,2653,-122,-4.5985676593
07407,福島県,磐梯町,磐梯町,3581,3761,-180,-4.7859611805,59.68,60.0,1117,1131,-14,-1.2378426172
07408,福島県,猪苗代町,猪苗代町,15047,15805,-758,-4.7959506485,394.94,38.1,4940,4954,-14,-0.2825999193
07420,福島県,河沼郡,河沼郡,23065,24733,-1668,-6.7440261998,283.79,81.3,7506,7545,-39,-0.5168986083
07421,福島県,会津坂下町,会津坂下町,16320,17360,-1040,-5.9907834101,91.59,178.2,5381,5371,10,0.1861850680
07422,福島県,湯川村,湯川村,3207,3364,-157,-4.6670630202,16.37,195.9,906,915,-9,-0.9836065574
07423,福島県,柳津町,柳津町,3538,4009,-471,-11.7485657271,175.82,20.1,1219,1259,-40,-3.1771247021
07440,福島県,大沼郡,大沼郡,26097,28625,-2528,-8.8314410480,870.51,30.0,8968,9241,-273,-2.9542257331
07444,福島県,三島町,三島町,1668,1926,-258,-13.3956386293,90.81,18.4,683,747,-64,-8.5676037483
07445,福島県,金山町,金山町,2175,2462,-287,-11.6571892770,293.92,7.4,956,1042,-86,-8.2533589251
07446,福島県,昭和村,昭和村,1322,1500,-178,-11.8666666667,209.46,6.3,616,646,-30,-4.6439628483
07447,福島県,会津美里町,会津美里町,20932,22737,-1805,-7.9386022782,276.33,75.8,6713,6806,-93,-1.3664413753
07460,福島県,西白河郡,西白河郡,49269,50130,-861,-1.7175344105,306.80,160.6,16816,16047,769,4.7921729918
07461,福島県,西郷村,西郷村,20328,19767,561,2.8380634391,192.06,105.8,7459,6711,748,11.1458798987
07464,福島県,泉崎村,泉崎村,6494,6802,-308,-4.5280799765,35.43,183.3,2050,2006,44,2.1934197408
07465,福島県,中島村,中島村,4995,5154,-159,-3.0849825378,18.92,264.0,1394,1387,7,0.5046863735
07466,福島県,矢吹町,矢吹町,17452,18407,-955,-5.1882436030,60.40,288.9,5913,5943,-30,-0.5047955578
07480,福島県,東白川郡,東白川郡,32960,35283,-2323,-6.5839072641,620.95,53.1,10771,10832,-61,-0.5631462334
07481,福島県,棚倉町,棚倉町,14302,15062,-760,-5.0458106493,159.93,89.4,4734,4708,26,0.5522514868
07482,福島県,矢祭町,矢祭町,5940,6348,-408,-6.4272211720,118.27,50.2,1920,1932,-12,-0.6211180124
07483,福島県,塙町,塙町,9141,9884,-743,-7.5171995144,211.41,43.2,3045,3086,-41,-1.3285806870
07484,福島県,鮫川村,鮫川村,3577,3989,-412,-10.3284031085,131.34,27.2,1072,1106,-34,-3.0741410488
07500,福島県,石川郡,石川郡,41105,44845,-3740,-8.3398372171,456.52,90.0,12944,13058,-114,-0.8730280288
07501,福島県,石川町,石川町,15884,17775,-1891,-10.6385372714,115.71,137.3,5246,5370,-124,-2.3091247672
07502,福島県,玉川村,玉川村,6773,7231,-458,-6.3338404093,46.67,145.1,1978,1923,55,2.8601144046
07503,福島県,平田村,平田村,6495,6921,-426,-6.1551798873,93.42,69.5,1995,2008,-13,-0.6474103586
07504,福島県,浅川町,浅川町,6577,6888,-311,-4.5150987224,37.43,175.7,2065,2029,36,1.7742730409
07505,福島県,古殿町,古殿町,5376,6030,-654,-10.8457711443,163.29,32.9,1660,1728,-68,-3.9351851852
07520,福島県,田村郡,田村郡,28772,29393,-621,-2.1127479332,197.95,145.3,9644,8997,647,7.1912859842
07521,福島県,三春町,三春町,18305,18191,114,0.6266835248,72.76,251.6,6230,5502,728,13.2315521628
07522,福島県,小野町,小野町,10467,11202,-735,-6.5613283342,125.18,83.6,3414,3495,-81,-2.3175965665
07540,福島県,双葉郡,双葉郡,7338,72822,-65484,-89.9233748043,865.71,8.5,4353,25471,-21118,-82.9099760512
07541,福島県,広野町,広野町,4323,5418,-1095,-20.2104097453,58.69,73.7,2428,1810,618,34.1436464088
07542,福島県,楢葉町,楢葉町,976,7700,-6724,-87.3246753247,103.64,9.4,839,2576,-1737,-67.4301242236
07543,福島県,富岡町,富岡町,0,16001,-16001,-100.0000000000,68.39,0.0,0,6141,-6141,-100.0000000000
07544,福島県,川内村,川内村,2021,2820,-799,-28.3333333333,197.35,10.2,1077,950,127,13.3684210526
07545,福島県,大熊町,大熊町,0,11515,-11515,-100.0000000000,78.71,0.0,0,3955,-3955,-100.0000000000
07546,福島県,双葉町,双葉町,0,6932,-6932,-100.0000000000,51.42,0.0,0,2393,-2393,-100.0000000000
07547,福島県,浪江町,浪江町,0,20905,-20905,-100.0000000000,223.14,0.0,0,7176,-7176,-100.0000000000
07548,福島県,葛尾村,葛尾村,18,1531,-1513,-98.8242978445,84.37,0.2,9,470,-461,-98.0851063830
07560,福島県,相馬郡,相馬郡,8261,14433,-6172,-42.7631123121,276.67,29.9,2694,4195,-1501,-35.7806912992
07561,福島県,新地町,新地町,8220,8224,-4,-0.0486381323,46.53,176.7,2693,2461,232,9.4270621698
07564,福島県,飯舘村,飯舘村,41,6209,-6168,-99.3396682235,230.13,0.2,1,1734,-1733,-99.9423298731
08201,茨城県,水戸市,水戸市,270823,268750,2073,0.7713488372,217.32,1246.2,117564,112099,5465,4.8751549969
08202,茨城県,日立市,日立市,185149,193129,-7980,-4.1319532540,225.71,820.3,78653,77965,688,0.8824472520
08203,茨城県,土浦市,土浦市,140948,143839,-2891,-2.0098860532,122.89,1146.9,57232,56663,569,1.0041826236
08204,茨城県,古河市,古河市,140975,142995,-2020,-1.4126368055,123.58,1140.8,52511,50465,2046,4.0542950560
08205,茨城県,石岡市,石岡市,76030,79687,-3657,-4.5892052656,215.53,352.8,27275,27094,181,0.6680445855
08207,茨城県,結城市,結城市,51605,52494,-889,-1.6935268793,65.76,784.7,18228,17466,762,4.3627619375
08208,茨城県,龍ケ崎市,龍ケ崎市,78368,80334,-1966,-2.4472825952,78.55,997.7,30445,30092,353,1.1730692543
08210,茨城県,下妻市,下妻市,43334,44987,-1653,-3.6743948252,80.88,535.8,15025,14890,135,0.9066487576
08211,茨城県,常総市,常総市,61460,65320,-3860,-5.9093692590,123.64,497.1,20552,20685,-133,-0.6429780034
08212,茨城県,常陸太田市,常陸太田市,52326,56250,-3924,-6.9760000000,371.99,140.7,19434,19801,-367,-1.8534417454
08214,茨城県,高萩市,高萩市,29656,31017,-1361,-4.3879163040,193.58,153.2,11716,11661,55,0.4716576623
08215,茨城県,北茨城市,北茨城市,44443,47026,-2583,-5.4927061625,186.80,237.9,16858,16966,-108,-0.6365672522
08216,茨城県,笠間市,笠間市,76766,79409,-2643,-3.3283380977,240.40,319.3,28178,27946,232,0.8301724755
08217,茨城県,取手市,取手市,106564,109651,-3087,-2.8152958021,69.94,1523.6,43458,42614,844,1.9805697658
08219,茨城県,牛久市,牛久市,84454,81684,2770,3.3911169874,58.92,1433.4,33270,31569,1701,5.3881972821
08220,茨城県,つくば市,つくば市,227029,214590,12439,5.7966354443,283.72,800.2,98138,87477,10661,12.1872034935
08221,茨城県,ひたちなか市,ひたちなか市,155680,157060,-1380,-0.8786451038,99.83,1559.5,61196,60268,928,1.5397889427
08222,茨城県,鹿嶋市,鹿嶋市,67885,66093,1792,2.7113310033,106.02,640.3,27451,25199,2252,8.9368625739
08223,茨城県,潮来市,潮来市,29105,30534,-1429,-4.6800288203,71.40,407.6,10542,10384,158,1.5215716487
08224,茨城県,守谷市,守谷市,64763,62482,2281,3.6506513876,35.71,1813.6,24844,22854,1990,8.7074472740
08225,茨城県,常陸大宮市,常陸大宮市,42587,45178,-2591,-5.7350923016,348.45,122.2,16011,16087,-76,-0.4724311556
08226,茨城県,那珂市,那珂市,54270,54240,30,0.0553097345,97.82,554.8,20009,18889,1120,5.9293768860
08227,茨城県,筑西市,筑西市,104617,108527,-3910,-3.6027900891,205.30,509.6,35666,35188,478,1.3584176424
08228,茨城県,坂東市,坂東市,54073,56114,-2041,-3.6372384788,123.03,439.5,17280,16763,517,3.0841734773
08229,茨城県,稲敷市,稲敷市,42769,46895,-4126,-8.7983793581,205.81,207.8,14427,14809,-382,-2.5795124586
08230,茨城県,かすみがうら市,かすみがうら市,42143,43553,-1410,-3.2374348495,156.60,269.1,15113,14730,383,2.6001357773
08231,茨城県,桜川市,桜川市,42651,45673,-3022,-6.6166006174,180.06,236.9,13615,13632,-17,-0.1247065728
08232,茨城県,神栖市,神栖市,94582,94795,-213,-0.2246953953,146.94,643.7,37003,35901,1102,3.0695523802
08233,茨城県,行方市,行方市,34915,37611,-2696,-7.1681157108,222.48,156.9,11104,11346,-242,-2.1329102767
08234,茨城県,鉾田市,鉾田市,48156,50156,-2000,-3.9875588165,207.61,232.0,17374,16810,564,3.3551457466
08235,茨城県,つくばみらい市,つくばみらい市,49146,44461,4685,10.5373248465,79.16,620.8,18148,15273,2875,18.8240686178
08236,茨城県,小美玉市,小美玉市,50917,52279,-1362,-2.6052525871,144.74,351.8,17552,17207,345,2.0049979659
08300,茨城県,東茨城郡,東茨城郡,69625,74332,-4707,-6.3324005812,307.12,226.7,25077,25350,-273,-1.0769230769
08302,茨城県,茨城町,茨城町,32930,34513,-1583,-4.5866774838,121.58,270.9,11354,11187,167,1.4928041477
08309,茨城県,大洗町,大洗町,16891,18328,-1437,-7.8404626801,23.74,711.5,6656,7021,-365,-5.1986896453
08310,茨城県,城里町,城里町,19804,21491,-1687,-7.8497975897,161.80,122.4,7067,7142,-75,-1.0501260151
08340,茨城県,那珂郡,那珂郡,37716,37438,278,0.7425610342,37.98,993.0,14476,14113,363,2.5720966485
08341,茨城県,東海村,東海村,37716,37438,278,0.7425610342,37.98,993.0,14476,14113,363,2.5720966485
08360,茨城県,久慈郡,久慈郡,18144,20073,-1929,-9.6099237782,325.76,55.7,6734,7140,-406,-5.6862745098
08364,茨城県,大子町,大子町,18144,20073,-1929,-9.6099237782,325.76,55.7,6734,7140,-406,-5.6862745098
08440,茨城県,稲敷郡,稲敷郡,72570,75411,-2841,-3.7673548952,182.30,398.1,27741,27278,463,1.6973385146
08442,茨城県,美浦村,美浦村,15851,17299,-1448,-8.3704260362,66.61,238.0,5975,6305,-330,-5.2339413164
08443,茨城県,阿見町,阿見町,47545,47940,-395,-0.8239465999,71.40,665.9,18820,17969,851,4.7359341087
08447,茨城県,河内町,河内町,9174,10172,-998,-9.8112465592,44.30,207.1,2946,3004,-58,-1.9307589880
08520,茨城県,結城郡,結城郡,22008,23106,-1098,-4.7520124643,58.99,373.1,6814,6756,58,0.8584961516
08521,茨城県,八千代町,八千代町,22008,23106,-1098,-4.7520124643,58.99,373.1,6814,6756,58,0.8584961516
08540,茨城県,猿島郡,猿島郡,33304,35124,-1820,-5.1816421820,69.70,477.8,10958,10850,108,0.9953917051
08542,茨城県,五霞町,五霞町,8784,9410,-626,-6.6524973433,23.11,380.1,2890,2927,-37,-1.2640929279
08546,茨城県,境町,境町,24520,25714,-1194,-4.6433849265,46.59,526.3,8068,7923,145,1.8301148555
08560,茨城県,北相馬郡,北相馬郡,16301,17473,-1172,-6.7074915584,24.90,654.7,6130,6131,-1,-0.0163105529
08564,茨城県,利根町,利根町,16301,17473,-1172,-6.7074915584,24.90,654.7,6130,6131,-1,-0.0163105529
09201,栃木県,宇都宮市,宇都宮市,518761,511739,7022,1.3721838672,416.85,1244.5,217372,210482,6890,3.2734390589
09202,栃木県,足利市,足利市,149504,154530,-5026,-3.2524428913,177.76,841.0,60111,59134,977,1.6521797950
09203,栃木県,栃木市,栃木市,159267,164024,-4757,-2.9001853387,331.50,480.4,57745,56489,1256,2.2234417320
09204,栃木県,佐野市,佐野市,118919,121249,-2330,-1.9216653333,356.04,334.0,46330,45178,1152,2.5499136748
09205,栃木県,鹿沼市,鹿沼市,98384,102348,-3964,-3.8730605386,490.64,200.5,35060,34999,61,0.1742906940
09206,栃木県,日光市,日光市,83446,90066,-6620,-7.3501654342,1449.83,57.6,32654,33926,-1272,-3.7493367918
09208,栃木県,小山市,小山市,166795,164454,2341,1.4234983643,171.76,971.1,65727,62844,2883,4.5875501241
09209,栃木県,真岡市,真岡市,79579,82289,-2710,-3.2932712756,167.34,475.6,27934,27577,357,1.2945570584
09210,栃木県,大田原市,大田原市,75480,77729,-2249,-2.8933859949,354.36,213.0,28743,28075,668,2.3793410508
09211,栃木県,矢板市,矢板市,33362,35343,-1981,-5.6050703110,170.46,195.7,12275,12438,-163,-1.3105000804
09213,栃木県,那須塩原市,那須塩原市,117044,117812,-768,-0.6518860557,592.74,197.5,45563,44602,961,2.1546119008
09214,栃木県,さくら市,さくら市,44916,44768,148,0.3305932809,125.63,357.5,15630,14917,713,4.7797814574
09215,栃木県,那須烏山市,那須烏山市,27012,29206,-2194,-7.5121550366,174.35,154.9,9480,9586,-106,-1.1057792614
09216,栃木県,下野市,下野市,59444,59483,-39,-0.0655649513,74.59,796.9,21349,20501,848,4.1363835910
09300,栃木県,河内郡,河内郡,31055,31621,-566,-1.7899497170,54.39,571.0,10737,10390,347,3.3397497594
09301,栃木県,上三川町,上三川町,31055,31621,-566,-1.7899497170,54.39,571.0,10737,10390,347,3.3397497594
09340,栃木県,芳賀郡,芳賀郡,63412,67490,-4078,-6.0423766484,396.50,159.9,21430,21525,-95,-0.4413472706
09342,栃木県,益子町,益子町,23299,24348,-1049,-4.3083620831,89.40,260.6,7785,7801,-16,-0.2051019100
09343,栃木県,茂木町,茂木町,13188,15018,-1830,-12.1853775469,172.69,76.4,4569,4799,-230,-4.7926651386
09344,栃木県,市貝町,市貝町,11724,12094,-370,-3.0593682818,64.25,182.5,4102,4018,84,2.0905923345
09345,栃木県,芳賀町,芳賀町,15201,16030,-829,-5.1715533375,70.16,216.7,4974,4907,67,1.3653963725
09360,栃木県,下都賀郡,下都賀郡,65254,65325,-71,-0.1086873326,91.32,714.6,24782,23336,1446,6.1964346932
09361,栃木県,壬生町,壬生町,39944,39605,339,0.8559525312,61.06,654.2,15216,14214,1002,7.0493879274
09364,栃木県,野木町,野木町,25310,25720,-410,-1.5940902022,30.26,836.4,9566,9122,444,4.8673536505
09380,栃木県,塩谷郡,塩谷郡,41152,42996,-1844,-4.2887710485,246.92,166.7,15199,15029,170,1.1311464502
09384,栃木県,塩谷町,塩谷町,11496,12560,-1064,-8.4713375796,176.06,65.3,3687,3828,-141,-3.6833855799
09386,栃木県,高根沢町,高根沢町,29656,30436,-780,-2.5627546327,70.87,418.5,11512,11201,311,2.7765378091
09400,栃木県,那須郡,那須郡,41885,45211,-3326,-7.3566167526,565.12,74.1,14414,14576,-162,-1.1114160263
09407,栃木県,那須町,那須町,24922,26765,-1843,-6.8858583972,372.34,66.9,8583,8699,-116,-1.3334866077
09411,栃木県,那珂川町,那珂川町,16963,18446,-1483,-8.0396834002,192.78,88.0,5831,5877,-46,-0.7827122682
10201,群馬県,前橋市,前橋市,336199,340291,-4092,-1.2025002131,311.59,1079.0,136747,133322,3425,2.5689683623
10202,群馬県,高崎市,高崎市,370751,371302,-551,-0.1483967229,459.16,807.5,150464,147116,3348,2.2757551864
10203,群馬県,桐生市,桐生市,114760,121704,-6944,-5.7056464866,274.45,418.1,46021,46688,-667,-1.4286326251
10204,群馬県,伊勢崎市,伊勢崎市,208838,207221,1617,0.7803263183,139.44,1497.7,79852,76527,3325,4.3448717446
10205,群馬県,太田市,太田市,219896,216465,3431,1.5850137436,175.54,1252.7,86134,81437,4697,5.7676486118
10206,群馬県,沼田市,沼田市,48697,51265,-2568,-5.0092655808,443.46,109.8,19106,19148,-42,-0.2193440568
10207,群馬県,館林市,館林市,76676,78608,-1932,-2.4577651130,60.97,1257.6,30205,29581,624,2.1094621548
10208,群馬県,渋川市,渋川市,78426,83330,-4904,-5.8850354014,240.27,326.4,28808,29290,-482,-1.6456128371
10209,群馬県,藤岡市,藤岡市,65723,67975,-2252,-3.3129827142,180.29,364.5,24549,24298,251,1.0330068318
10210,群馬県,富岡市,富岡市,49760,52070,-2310,-4.4363357019,122.85,405.0,18252,18297,-45,-0.2459419577
10211,群馬県,安中市,安中市,58529,61077,-2548,-4.1717831590,276.31,211.8,22377,22184,193,0.8699963938
10212,群馬県,みどり市,みどり市,50942,51899,-957,-1.8439661651,208.42,244.4,18826,18336,490,2.6723385689
10340,群馬県,北群馬郡,北群馬郡,35424,34171,1253,3.6668520090,48.38,732.2,12167,11164,1003,8.9842350412
10344,群馬県,榛東村,榛東村,14338,14370,-32,-0.2226861517,27.92,513.5,4883,4634,249,5.3733275788
10345,群馬県,吉岡町,吉岡町,21086,19801,1285,6.4895712338,20.46,1030.6,7284,6530,754,11.5467075038
10360,群馬県,多野郡,多野郡,3184,3658,-474,-12.9579004921,296.44,10.7,1480,1650,-170,-10.3030303030
10366,群馬県,上野村,上野村,1228,1306,-78,-5.9724349158,181.85,6.8,577,612,-35,-5.7189542484
10367,群馬県,神流町,神流町,1956,2352,-396,-16.8367346939,114.60,17.1,903,1038,-135,-13.0057803468
10380,群馬県,甘楽郡,甘楽郡,22823,24952,-2129,-8.5323821738,365.81,62.4,8532,8851,-319,-3.6041125297
10382,群馬県,下仁田町,下仁田町,7633,8911,-1278,-14.3418247110,188.38,40.5,3040,3316,-276,-8.3232810615
10383,群馬県,南牧村,南牧村,1980,2423,-443,-18.2831200991,118.83,16.7,953,1088,-135,-12.4080882353
10384,群馬県,甘楽町,甘楽町,13210,13618,-408,-2.9960346600,58.61,225.4,4539,4447,92,2.0688104340
10420,群馬県,吾妻郡,吾妻郡,56413,61109,-4696,-7.6846291054,1278.55,44.1,22022,22726,-704,-3.0977734753
10421,群馬県,中之条町,中之条町,16842,18216,-1374,-7.5428194993,439.28,38.3,6516,6608,-92,-1.3922518160
10424,群馬県,長野原町,長野原町,5477,6017,-540,-8.9745720459,133.85,40.9,2183,2295,-112,-4.8801742919
10425,群馬県,嬬恋村,嬬恋村,9787,10183,-396,-3.8888343317,337.58,29.0,3659,3651,8,0.2191180498
10426,群馬県,草津町,草津町,6512,7160,-648,-9.0502793296,49.75,130.9,3244,3474,-230,-6.6206102476
10428,群馬県,高山村,高山村,3679,3911,-232,-5.9319867042,64.18,57.3,1167,1179,-12,-1.0178117048
10429,群馬県,東吾妻町,東吾妻町,14116,15622,-1506,-9.6402509282,253.91,55.6,5253,5519,-266,-4.8197137163
10440,群馬県,利根郡,利根郡,34749,37767,-3018,-7.9911033442,1322.23,26.3,12631,12944,-313,-2.4181087763
10443,群馬県,片品村,片品村,4390,4904,-514,-10.4812398042,391.76,11.2,1558,1677,-119,-7.0960047704
10444,群馬県,川場村,川場村,3648,3898,-250,-6.4135454079,85.25,42.8,997,974,23,2.3613963039
10448,群馬県,昭和村,昭和村,7355,7620,-265,-3.4776902887,64.14,114.7,2474,2429,45,1.8526142445
10449,群馬県,みなかみ町,みなかみ町,19356,21345,-1989,-9.3183415320,781.08,24.8,7602,7864,-262,-3.3316378433
10460,群馬県,佐波郡,佐波郡,36653,37536,-883,-2.3524083546,25.78,1421.8,14266,13857,409,2.9515768204
10464,群馬県,玉村町,玉村町,36653,37536,-883,-2.3524083546,25.78,1421.8,14266,13857,409,2.9515768204
10520,群馬県,邑楽郡,邑楽郡,105033,105668,-635,-0.6009387894,132.36,793.5,40747,38340,2407,6.2780386020
10521,群馬県,板倉町,板倉町,15024,15706,-682,-4.3422895709,41.86,358.9,5355,5129,226,4.4063170209
10522,群馬県,明和町,明和町,11042,11209,-167,-1.4898742082,19.64,562.2,3904,3696,208,5.6277056277
10523,群馬県,千代田町,千代田町,11331,11473,-142,-1.2376884860,21.73,521.4,3937,3719,218,5.8617908040
10524,群馬県,大泉町,大泉町,41213,40257,956,2.3747422808,18.03,2285.8,18021,16600,1421,8.5602409639
10525,群馬県,邑楽町,邑楽町,26423,27023,-600,-2.2203308293,31.11,849.3,9530,9196,334,3.6320139191
11101,埼玉県,さいたま市西区,さいたま市 西区,87156,84029,3127,3.7213343013,29.12,2993.0,33914,31406,2508,7.9857352098
11102,埼玉県,さいたま市北区,さいたま市 北区,143628,138630,4998,3.6052802424,16.86,8518.9,61753,58382,3371,5.7740399438
11103,埼玉県,さいたま市大宮区,さいたま市 大宮区,113794,108488,5306,4.8908635056,12.80,8890.2,53218,48475,4743,9.7844249613
11104,埼玉県,さいたま市見沼区,さいたま市 見沼区,162013,157143,4870,3.0990880917,30.69,5279.0,65661,61585,4076,6.6184947633
11105,埼玉県,さいたま市中央区,さいたま市 中央区,98750,96055,2695,2.8056842434,8.39,11770.0,42838,41153,1685,4.0944767089
11106,埼玉県,さいたま市桜区,さいたま市 桜区,97943,96911,1032,1.0648945940,18.64,5254.5,43472,42442,1030,2.4268413364
11107,埼玉県,さいたま市浦和区,さいたま市 浦和区,154393,144786,9607,6.6353100438,11.51,13413.8,67100,61994,5106,8.2362809304
11108,埼玉県,さいたま市南区,さいたま市 南区,180180,174988,5192,2.9670605984,13.82,13037.6,77790,74885,2905,3.8792815651
11109,埼玉県,さいたま市緑区,さいたま市 緑区,116562,110118,6444,5.8519043208,26.44,4408.5,44460,40862,3598,8.8052469287
11110,埼玉県,さいたま市岩槻区,さいたま市 岩槻区,109834,111286,-1452,-1.3047463293,49.17,2233.8,43221,41942,1279,3.0494492394
11201,埼玉県,川越市,川越市,350327,342670,7657,2.2345113374,109.13,3210.2,145690,137121,8569,6.2492251369
11202,埼玉県,熊谷市,熊谷市,198639,203180,-4541,-2.2349640713,159.82,1242.9,77079,75413,1666,2.2091681806
11203,埼玉県,川口市,川口市,578245,561506,16739,2.9810901397,61.95,9334.1,245482,234124,11358,4.8512753925
11206,埼玉県,行田市,行田市,82142,85786,-3644,-4.2477793579,67.49,1217.1,30995,30630,365,1.1916421809
11207,埼玉県,秩父市,秩父市,63545,66955,-3410,-5.0929728922,577.83,110.0,24039,24146,-107,-0.4431375797
11208,埼玉県,所沢市,所沢市,335875,341924,-6049,-1.7691065851,72.11,4657.8,144970,141225,3745,2.6517967782
11209,埼玉県,飯能市,飯能市,80735,83549,-2814,-3.3680834002,193.05,418.2,31744,30905,839,2.7147710726
11210,埼玉県,加須市,加須市,112302,115002,-2700,-2.3477852559,133.30,842.5,40735,39460,1275,3.2311201216
11211,埼玉県,本庄市,本庄市,77885,81889,-4004,-4.8895456044,89.69,868.4,30945,32217,-1272,-3.9482260918
11212,埼玉県,東松山市,東松山市,91445,90099,1346,1.4939122521,65.35,1399.3,37240,34945,2295,6.5674631564
11214,埼玉県,春日部市,春日部市,232372,237171,-4799,-2.0234345683,66.00,3520.8,94399,91531,2868,3.1333646524
11215,埼玉県,狭山市,狭山市,152393,155727,-3334,-2.1409261079,48.99,3110.7,61983,61039,944,1.5465522043
11216,埼玉県,羽生市,羽生市,54984,56204,-1220,-2.1706640097,58.64,937.7,20430,19473,957,4.9144969958
11217,埼玉県,鴻巣市,鴻巣市,118122,119639,-1517,-1.2679811767,67.44,1751.5,45009,43379,1630,3.7575785518
11218,埼玉県,深谷市,深谷市,143833,144618,-785,-0.5428093322,138.37,1039.5,53343,50859,2484,4.8840913113
11219,埼玉県,上尾市,上尾市,225186,223926,1260,0.5626858873,45.51,4948.1,91270,87286,3984,4.5643058452
11221,埼玉県,草加市,草加市,247076,243855,3221,1.3208669086,27.46,8997.7,106072,102479,3593,3.5060841733
11222,埼玉県,越谷市,越谷市,337562,326313,11249,3.4473036624,60.24,5603.6,136528,128342,8186,6.3782705584
11223,埼玉県,蕨市,蕨市,72240,71502,738,1.0321389611,5.11,14137.0,33979,33112,867,2.6183860836
11224,埼玉県,戸田市,戸田市,136083,123079,13004,10.5655717060,18.19,7481.2,59314,54495,4819,8.8430131205
11225,埼玉県,入間市,入間市,148438,149872,-1434,-0.9568164834,44.69,3321.5,58965,56843,2122,3.7330893866
11227,埼玉県,朝霞市,朝霞市,136041,129691,6350,4.8962534023,18.34,7417.7,59510,56790,2720,4.7895756295
11228,埼玉県,志木市,志木市,72656,69611,3045,4.3743086581,9.05,8028.3,30597,28433,2164,7.6108746879
11229,埼玉県,和光市,和光市,80754,80745,9,0.0111462010,11.04,7314.7,36847,37385,-538,-1.4390798449
11230,埼玉県,新座市,新座市,162181,158777,3404,2.1438873388,22.78,7119.4,67153,64436,2717,4.2165870011
11231,埼玉県,桶川市,桶川市,73932,74711,-779,-1.0426844775,25.35,2916.4,28521,28047,474,1.6900203230
11232,埼玉県,久喜市,久喜市,151904,154310,-2406,-1.5591990150,82.41,1843.3,59420,57238,2182,3.8121527656
11233,埼玉県,北本市,北本市,67414,68888,-1474,-2.1397050285,19.82,3401.3,26823,25856,967,3.7399443069
11234,埼玉県,八潮市,八潮市,86670,82977,3693,4.4506308977,18.02,4809.7,35860,32467,3393,10.4506113900
11235,埼玉県,富士見市,富士見市,108104,106736,1368,1.2816669165,19.77,5468.1,47163,44642,2521,5.6471484252
11237,埼玉県,三郷市,三郷市,136528,131415,5113,3.8907278469,30.13,4531.3,55179,51132,4047,7.9148087303
11238,埼玉県,蓮田市,蓮田市,62387,63309,-922,-1.4563490183,27.28,2286.9,24503,23445,1058,4.5126892728
11239,埼玉県,坂戸市,坂戸市,101648,101700,-52,-0.0511307768,41.02,2478.0,42728,41508,1220,2.9391924448
11240,埼玉県,幸手市,幸手市,52535,54012,-1477,-2.7345775013,33.93,1548.3,20558,19904,654,3.2857717042
11241,埼玉県,鶴ヶ島市,鶴ヶ島市,70267,69990,277,0.3957708244,17.65,3981.1,28627,27746,881,3.1752324659
11242,埼玉県,日高市,日高市,56521,57473,-952,-1.6564299758,47.48,1190.4,21998,21227,771,3.6321665803
11243,埼玉県,吉川市,吉川市,69759,65298,4461,6.8317559496,31.66,2203.4,25681,23248,2433,10.4654163799
11245,埼玉県,ふじみ野市,ふじみ野市,111011,105695,5316,5.0295662046,14.64,7582.7,45583,42763,2820,6.5944858873
11246,埼玉県,白岡市,白岡市,51550,50272,1278,2.5421705920,24.92,2068.6,19146,17869,1277,7.1464547540
11300,埼玉県,北足立郡,北足立郡,44434,42494,1940,4.5653504024,14.79,3004.3,16683,15504,1179,7.6044891641
11301,埼玉県,伊奈町,伊奈町,44434,42494,1940,4.5653504024,14.79,3004.3,16683,15504,1179,7.6044891641
11320,埼玉県,入間郡,入間郡,87439,90297,-2858,-3.1651106903,89.79,973.8,34497,34150,347,1.0161054173
11324,埼玉県,三芳町,三芳町,38459,38706,-247,-0.6381439570,15.33,2508.7,14353,13940,413,2.9626972740
11326,埼玉県,毛呂山町,毛呂山町,37289,39054,-1765,-4.5193834178,34.07,1094.5,15595,15644,-49,-0.3132191255
11327,埼玉県,越生町,越生町,11691,12537,-846,-6.7480258435,40.39,289.5,4549,4566,-17,-0.3723171266
11340,埼玉県,比企郡,比企郡,133901,140072,-6171,-4.4055914101,281.86,475.1,49120,48071,1049,2.1821888457
11341,埼玉県,滑川町,滑川町,18211,17323,888,5.1261328869,29.68,613.6,6712,6186,526,8.5030714517
11342,埼玉県,嵐山町,嵐山町,18346,18887,-541,-2.8644040875,29.92,613.2,6987,6708,279,4.1592128801
11343,埼玉県,小川町,小川町,31193,32913,-1720,-5.2258985811,60.36,516.8,11998,11645,353,3.0313439244
11346,埼玉県,川島町,川島町,20669,22147,-1478,-6.6735901025,41.63,496.5,7113,7112,1,0.0140607424
11347,埼玉県,吉見町,吉見町,19635,21079,-1444,-6.8504198491,38.64,508.2,6817,6804,13,0.1910640800
11348,埼玉県,鳩山町,鳩山町,14347,15305,-958,-6.2593923554,25.73,557.6,5310,5335,-25,-0.4686035614
11349,埼玉県,ときがわ町,ときがわ町,11500,12418,-918,-7.3924947657,55.90,205.7,4183,4281,-98,-2.2891847699
11360,埼玉県,秩父郡,秩父郡,41020,44619,-3599,-8.0660705081,351.84,116.6,14800,15131,-331,-2.1875619589
11361,埼玉県,横瀬町,横瀬町,8520,9039,-519,-5.7417855958,49.36,172.6,3060,3078,-18,-0.5847953216
11362,埼玉県,皆野町,皆野町,10128,10888,-760,-6.9801616458,63.74,158.9,3657,3762,-105,-2.7910685805
11363,埼玉県,長瀞町,長瀞町,7326,7908,-582,-7.3596358118,30.43,240.7,2644,2713,-69,-2.5433099889
11365,埼玉県,小鹿野町,小鹿野町,12105,13436,-1331,-9.9062220899,171.26,70.7,4407,4503,-96,-2.1319120586
11369,埼玉県,東秩父村,東秩父村,2941,3348,-407,-12.1565113501,37.06,79.4,1032,1075,-43,-4.0000000000
11380,埼玉県,児玉郡,児玉郡,55399,57073,-1674,-2.9330856973,109.99,503.7,19789,19438,351,1.8057413314
11381,埼玉県,美里町,美里町,11211,11605,-394,-3.3950883240,33.41,335.6,3577,3550,27,0.7605633803
11383,埼玉県,神川町,神川町,13704,14470,-766,-5.2937111265,47.40,289.1,5026,5001,25,0.4999000200
11385,埼玉県,上里町,上里町,30484,30998,-514,-1.6581714949,29.18,1044.7,11186,10887,299,2.7463947828
11400,埼玉県,大里郡,大里郡,34092,35774,-1682,-4.7017386929,64.25,530.6,12922,12694,228,1.7961241531
11408,埼玉県,寄居町,寄居町,34092,35774,-1682,-4.7017386929,64.25,530.6,12922,12694,228,1.7961241531
11440,埼玉県,南埼玉郡,南埼玉郡,33859,33641,218,0.6480187866,15.95,2122.8,13782,13190,592,4.4882486732
11442,埼玉県,宮代町,宮代町,33859,33641,218,0.6480187866,15.95,2122.8,13782,13190,592,4.4882486732
11460,埼玉県,北葛飾郡,北葛飾郡,75583,78076,-2493,-3.1930426764,46.23,1634.9,27850,27131,719,2.6501050459
11464,埼玉県,杉戸町,杉戸町,45521,46923,-1402,-2.9878737506,30.03,1515.9,17232,16704,528,3.1609195402
11465,埼玉県,松伏町,松伏町,30062,31153,-1091,-3.5020704266,16.20,1855.7,10618,10427,191,1.8317828714
12101,千葉県,千葉市中央区,千葉市 中央区,205187,199364,5823,2.9207881062,44.69,4591.3,95248,93614,1634,1.7454654218
12102,千葉県,千葉市花見川区,千葉市 花見川区,179286,180949,-1663,-0.9190434874,34.19,5243.8,77544,76051,1493,1.9631563030
12103,千葉県,千葉市稲毛区,千葉市 稲毛区,161162,157768,3394,2.1512600781,21.22,7594.8,71072,68503,2569,3.7502007211
12104,千葉県,千葉市若葉区,千葉市 若葉区,151306,151585,-279,-0.1840551506,84.21,1796.8,63054,61484,1570,2.5535098562
12105,千葉県,千葉市緑区,千葉市 緑区,126931,121921,5010,4.1092182643,66.25,1915.9,46760,44004,2756,6.2630669939
12106,千葉県,千葉市美浜区,千葉市 美浜区,148767,150162,-1395,-0.9289966836,21.20,7017.3,63962,62653,1309,2.0892854293
12202,千葉県,銚子市,銚子市,64431,70210,-5779,-8.2310212220,84.19,765.3,26131,27035,-904,-3.3438135750
12203,千葉県,市川市,市川市,481492,473919,7573,1.5979523927,57.45,8381.1,228684,220582,8102,3.6730104904
12204,千葉県,船橋市,船橋市,622823,609040,13783,2.2630697491,85.62,7274.3,271786,261415,10371,3.9672551307
12205,千葉県,館山市,館山市,47488,49290,-1802,-3.6559139785,110.15,431.1,20143,20232,-89,-0.4398971926
12206,千葉県,木更津市,木更津市,134175,129312,4863,3.7606718634,138.94,965.7,54843,50042,4801,9.5939410895
12207,千葉県,松戸市,松戸市,483238,484457,-1219,-0.2516219190,61.38,7872.9,215464,209570,5894,2.8124254426
12208,千葉県,野田市,野田市,153609,155491,-1882,-1.2103594420,103.55,1483.4,59654,58050,1604,2.7631352283
12210,千葉県,茂原市,茂原市,89730,93015,-3285,-3.5316884373,99.92,898.0,36023,35936,87,0.2420970614
12211,千葉県,成田市,成田市,131230,128933,2297,1.7815454538,213.84,613.7,55421,52894,2527,4.7774794873
12212,千葉県,佐倉市,佐倉市,172789,172183,606,0.3519511218,103.69,1666.4,69041,65035,4006,6.1597601292
12213,千葉県,東金市,東金市,60671,61751,-1080,-1.7489595310,89.12,680.8,25094,24378,716,2.9370744114
12215,千葉県,旭市,旭市,66601,69058,-2457,-3.5578788844,130.45,510.5,23318,23157,161,0.6952541348
12216,千葉県,習志野市,習志野市,168033,164530,3503,2.1290949979,20.97,8013.0,72213,70132,2081,2.9672617350
12217,千葉県,柏市,柏市,414054,404012,10042,2.4855697356,114.74,3608.6,175479,162287,13192,8.1288088387
12218,千葉県,勝浦市,勝浦市,19258,20788,-1530,-7.3600153935,93.96,205.0,8980,9179,-199,-2.1679921560
12219,千葉県,市原市,市原市,274558,280416,-5858,-2.0890391418,368.17,745.7,113664,111973,1691,1.5101854911
12220,千葉県,流山市,流山市,174417,163984,10433,6.3622060689,35.32,4938.2,70733,64921,5812,8.9524190940
12221,千葉県,八千代市,八千代市,193219,189781,3438,1.8115617475,51.39,3759.9,78206,74824,3382,4.5199401262
12222,千葉県,我孫子市,我孫子市,131653,134017,-2364,-1.7639553191,43.15,3051.1,54044,53170,874,1.6437840888
12223,千葉県,鴨川市,鴨川市,33954,35766,-1812,-5.0662640497,191.14,177.6,14445,14361,84,0.5849174849
12224,千葉県,鎌ケ谷市,鎌ケ谷市,108979,107853,1126,1.0440136111,21.08,5169.8,44127,41955,2172,5.1769753307
12225,千葉県,君津市,君津市,86055,89168,-3113,-3.4911627490,318.81,269.9,34459,33908,551,1.6249852542
12226,千葉県,富津市,富津市,45616,48073,-2457,-5.1109770557,205.53,221.9,17621,17311,310,1.7907688753
12227,千葉県,浦安市,浦安市,164086,164877,-791,-0.4797515724,17.30,9484.7,73996,71411,2585,3.6198904931
12228,千葉県,四街道市,四街道市,89272,86726,2546,2.9356824943,34.52,2586.1,34757,32514,2243,6.8985667712
12229,千葉県,袖ケ浦市,袖ケ浦市,60964,60355,609,1.0090299064,94.93,642.2,22650,21561,1089,5.0507861416
12230,千葉県,八街市,八街市,70806,73212,-2406,-3.2863465006,74.94,944.8,27088,25838,1250,4.8378357458
12231,千葉県,印西市,印西市,92684,88176,4508,5.1125022682,123.79,748.7,32583,29622,2961,9.9959489569
12232,千葉県,白井市,白井市,61729,60345,1384,2.2934791615,35.48,1739.8,22665,21207,1458,6.8750884142
12233,千葉県,富里市,富里市,49656,51087,-1431,-2.8011039991,53.88,921.6,20008,19701,307,1.5582965332
12234,千葉県,南房総市,南房総市,39044,42104,-3060,-7.2677180315,230.14,169.7,15052,15575,-523,-3.3579454254
12235,千葉県,匝瑳市,匝瑳市,37273,39814,-2541,-6.3821771236,101.52,367.1,12699,12873,-174,-1.3516662783
12236,千葉県,香取市,香取市,77526,82866,-5340,-6.4441387300,262.35,295.5,27263,27309,-46,-0.1684426380
12237,千葉県,山武市,山武市,52231,56089,-3858,-6.8783540445,146.77,355.9,19448,19286,162,0.8399875557
12238,千葉県,いすみ市,いすみ市,38620,40962,-2342,-5.7174942630,157.44,245.3,14845,14704,141,0.9589227421
12239,千葉県,大網白里市,大網白里市,49191,50113,-922,-1.8398419572,58.08,847.0,18847,18135,712,3.9261097326
12320,千葉県,印旛郡,印旛郡,42212,43814,-1602,-3.6563655453,51.52,819.3,17130,16575,555,3.3484162896
12322,千葉県,酒々井町,酒々井町,20972,21234,-262,-1.2338702082,19.01,1103.2,8946,8571,375,4.3752187609
12329,千葉県,栄町,栄町,21240,22580,-1340,-5.9344552702,32.51,653.3,8184,8004,180,2.2488755622
12340,千葉県,香取郡,香取郡,35032,37610,-2578,-6.8545599575,138.95,252.1,11811,11841,-30,-0.2533569800
12342,千葉県,神崎町,神崎町,6142,6454,-312,-4.8342113418,19.90,308.6,2205,2135,70,3.2786885246
12347,千葉県,多古町,多古町,14738,16002,-1264,-7.8990126234,72.80,202.4,5049,5145,-96,-1.8658892128
12349,千葉県,東庄町,東庄町,14152,15154,-1002,-6.6121156130,46.25,306.0,4557,4561,-4,-0.0877000658
12400,千葉県,山武郡,山武郡,47728,50599,-2871,-5.6740251784,134.70,354.3,17307,17369,-62,-0.3569577984
12403,千葉県,九十九里町,九十九里町,16521,18004,-1483,-8.2370584315,24.45,675.7,6425,6621,-196,-2.9602779036
12409,千葉県,芝山町,芝山町,7440,7920,-480,-6.0606060606,43.24,172.1,2449,2470,-21,-0.8502024291
12410,千葉県,横芝光町,横芝光町,23767,24675,-908,-3.6798378926,67.01,354.7,8433,8278,155,1.8724329548
12420,千葉県,長生郡,長生郡,60074,63385,-3311,-5.2236333517,226.97,264.7,21899,21554,345,1.6006309734
12421,千葉県,一宮町,一宮町,11770,12034,-264,-2.1937842779,22.97,512.4,4485,4393,92,2.0942408377
12422,千葉県,睦沢町,睦沢町,7228,7340,-112,-1.5258855586,35.59,203.1,2439,2400,39,1.6250000000
12423,千葉県,長生村,長生村,14372,14752,-380,-2.5759219089,28.29,508.0,5418,5032,386,7.6709062003
12424,千葉県,白子町,白子町,11160,12151,-991,-8.1557073492,27.50,405.8,4182,4274,-92,-2.1525503042
12426,千葉県,長柄町,長柄町,7338,8035,-697,-8.6745488488,47.11,155.8,2586,2639,-53,-2.0083364911
12427,千葉県,長南町,長南町,8206,9073,-867,-9.5558249752,65.51,125.3,2789,2816,-27,-0.9588068182
12440,千葉県,夷隅郡,夷隅郡,17163,18409,-1246,-6.7684284861,154.73,110.9,6493,6693,-200,-2.9881966233
12441,千葉県,大多喜町,大多喜町,9850,10671,-821,-7.6937494143,129.87,75.8,3444,3584,-140,-3.9062500000
12443,千葉県,御宿町,御宿町,7313,7738,-425,-5.4923752908,24.86,294.2,3049,3109,-60,-1.9298809907
12460,千葉県,安房郡,安房郡,8024,8950,-926,-10.3463687151,45.19,177.6,3325,3480,-155,-4.4540229885
12463,千葉県,鋸南町,鋸南町,8024,8950,-926,-10.3463687151,45.19,177.6,3325,3480,-155,-4.4540229885
13101,東京都,千代田区,千代田区,58344,47115,11229,23.8331741484,11.66,5003.8,33361,25560,7801,30.5203442879
13102,東京都,中央区,中央区,141087,122762,18325,14.9272576204,10.21,13818.5,79184,67981,11203,16.4796045954
13103,東京都,港区,港区,243390,205131,38259,18.6510083800,20.37,11948.5,130386,110113,20273,18.4110867927
13104,東京都,新宿区,新宿区,333363,326309,7054,2.1617546559,18.22,18296.5,203831,195434,8397,4.2965911766
13105,東京都,文京区,文京区,219806,206626,13180,6.3786745134,11.29,19469.1,120640,111753,8887,7.9523592208
13106,東京都,台東区,台東区,198512,175928,22584,12.8370697103,10.11,19635.2,111887,95413,16474,17.2659910075
13107,東京都,墨田区,墨田区,256416,247606,8810,3.5580720984,13.77,18621.4,130338,120797,9541,7.8983749596
13108,東京都,江東区,江東区,498144,460819,37325,8.0997094304,40.16,12404.0,244482,214424,30058,14.0180203709
13109,東京都,品川区,品川区,386687,365302,21385,5.8540604760,22.84,16930.3,212322,196132,16190,8.2546448310
13110,東京都,目黒区,目黒区,278105,268330,9775,3.6429023963,14.67,18957.4,144873,138028,6845,4.9591387255
13111,東京都,大田区,大田区,717565,693373,24192,3.4890311564,60.66,11829.3,371447,345608,25839,7.4763894354
13112,東京都,世田谷区,世田谷区,900391,877138,23253,2.6510081652,58.05,15510.6,462335,448961,13374,2.9788778981
13113,東京都,渋谷区,渋谷区,224815,204492,20323,9.9382860943,15.11,14878.6,135498,123746,11752,9.4968726262
13114,東京都,中野区,中野区,328685,314750,13935,4.4273232724,15.59,21083.1,195630,184267,11363,6.1665952124
13115,東京都,杉並区,杉並区,564846,549569,15277,2.7798147275,34.06,16583.9,312413,302805,9608,3.1729991248
13116,東京都,豊島区,豊島区,291066,284678,6388,2.2439387659,13.01,22372.5,176104,166214,9890,5.9501606363
13117,東京都,北区,北区,341074,335544,5530,1.6480699998,20.61,16549.0,176873,172568,4305,2.4946687683
13118,東京都,荒川区,荒川区,211518,203296,8222,4.0443491264,10.16,20818.7,101752,96161,5591,5.8142074230
13119,東京都,板橋区,板橋区,561937,535824,26113,4.8734285885,32.22,17440.6,291659,272683,18976,6.9589963437
13120,東京都,練馬区,練馬区,722108,716124,5984,0.8356094755,48.08,15018.9,337824,336163,1661,0.4941055381
13121,東京都,足立区,足立区,671108,683426,-12318,-1.8023897247,53.25,12603.0,310852,314618,-3766,-1.1970071642
13122,東京都,葛飾区,葛飾区,443293,442586,707,0.1597429652,34.80,12738.3,201360,197276,4084,2.0701960705
13123,東京都,江戸川区,江戸川区,680305,678967,1338,0.1970640694,49.90,13633.4,308328,304041,4287,1.4100072030
13201,東京都,八王子市,八王子市,576526,580053,-3527,-0.6080478853,186.38,3093.3,254008,249893,4115,1.6467047896
13202,東京都,立川市,立川市,175388,179668,-4280,-2.3821715609,24.36,7199.8,83355,80916,2439,3.0142369865
13203,東京都,武蔵野市,武蔵野市,144683,138734,5949,4.2880620468,10.98,13177.0,73981,71228,2753,3.8650530690
13204,東京都,三鷹市,三鷹市,187133,186083,1050,0.5642643337,16.42,11396.7,90396,90190,206,0.2284066970
13205,東京都,青梅市,青梅市,137177,139339,-2162,-1.5516115373,103.31,1327.8,54344,52544,1800,3.4257003654
13206,東京都,府中市,府中市,260132,255506,4626,1.8105249975,29.43,8839.0,119391,115166,4225,3.6686174739
13207,東京都,昭島市,昭島市,111511,112297,-786,-0.6999296508,17.34,6430.9,48156,47236,920,1.9476670336
13208,東京都,調布市,調布市,229644,223593,6051,2.7062564570,21.58,10641.5,110155,107919,2236,2.0719243136
13209,東京都,町田市,町田市,432516,427016,5500,1.2880079435,71.80,6023.9,186376,180172,6204,3.4433763293
13210,東京都,小金井市,小金井市,121590,118852,2738,2.3037054488,11.30,10760.2,59859,57695,2164,3.7507582979
13211,東京都,小平市,小平市,190245,187035,3210,1.7162563157,20.51,9275.7,82994,81784,1210,1.4795069940
13212,東京都,日野市,日野市,186374,180052,6322,3.5112078733,27.55,6764.9,84473,80138,4335,5.4094187527
13213,東京都,東村山市,東村山市,150130,153557,-3427,-2.2317445639,17.14,8759.0,64578,63985,593,0.9267797140
13214,東京都,国分寺市,国分寺市,122701,120650,2051,1.6999585578,11.46,10706.9,59116,57775,1341,2.3210731285
13215,東京都,国立市,国立市,73274,75510,-2236,-2.9611971924,8.15,8990.7,33627,35767,-2140,-5.9831688428
13218,東京都,福生市,福生市,58432,59796,-1364,-2.2810890361,10.16,5751.2,27413,27045,368,1.3606951377
13219,東京都,狛江市,狛江市,80074,78751,1323,1.6799786669,6.39,12531.1,39520,39168,352,0.8986928105
13220,東京都,東大和市,東大和市,85167,83068,2099,2.5268454760,13.42,6346.3,35570,33648,1922,5.7120779838
13221,東京都,清瀬市,清瀬市,74893,74104,789,1.0647198532,10.23,7320.9,32352,30954,1398,4.5163791432
13222,東京都,東久留米市,東久留米市,116668,116546,122,0.1046796973,12.88,9058.1,49904,49177,727,1.4783333672
13223,東京都,武蔵村山市,武蔵村山市,71268,70053,1215,1.7344010963,15.32,4652.0,28266,26790,1476,5.5095184770
13224,東京都,多摩市,多摩市,146627,147648,-1021,-0.6915095362,21.01,6978.9,65476,64078,1398,2.1817160336
13225,東京都,稲城市,稲城市,87645,84835,2810,3.3123121353,17.97,4877.3,36324,34842,1482,4.2534871707
13227,東京都,羽村市,羽村市,55845,57032,-1187,-2.0812876981,9.90,5640.9,23419,23449,-30,-0.1279372255
13228,東京都,あきる野市,あきる野市,80980,80868,112,0.1384973042,73.47,1102.2,30734,29385,1349,4.5907776076
13229,東京都,西東京市,西東京市,199823,196511,3312,1.6854018350,15.75,12687.2,89676,87457,2219,2.5372468756
13300,東京都,西多摩郡,西多摩郡,58228,58750,-522,-0.8885106383,375.86,154.9,21814,20962,852,4.0644976624
13303,東京都,瑞穂町,瑞穂町,33461,33497,-36,-0.1074723110,16.85,1985.8,13160,12369,791,6.3950198076
13305,東京都,日の出町,日の出町,17325,16650,675,4.0540540541,28.07,617.2,5773,5461,312,5.7132393335
13307,東京都,檜原村,檜原村,2207,2558,-351,-13.7216575450,105.41,20.9,837,915,-78,-8.5245901639
13308,東京都,奥多摩町,奥多摩町,5235,6045,-810,-13.3995037221,225.53,23.2,2044,2217,-173,-7.8033378439
13361,東京都,大島町,大島町,7883,8461,-578,-6.8313438128,90.76,86.9,3951,4098,-147,-3.5871156662
13362,東京都,利島村,利島村,338,341,-3,-0.8797653959,4.12,82.0,194,204,-10,-4.9019607843
13363,東京都,新島村,新島村,2750,2883,-133,-4.6132500867,27.52,99.9,1258,1251,7,0.5595523581
13364,東京都,神津島村,神津島村,1891,1889,2,0.1058761249,18.58,101.8,791,787,4,0.5082592122
13381,東京都,三宅村,三宅村,2482,2676,-194,-7.2496263079,55.27,44.9,1483,1578,-95,-6.0202788340
13382,東京都,御蔵島村,御蔵島村,335,348,-13,-3.7356321839,20.54,16.3,194,198,-4,-2.0202020202
13401,東京都,八丈町,八丈町,7615,8231,-616,-7.4839023205,72.21,105.5,3920,4090,-170,-4.1564792176
13402,東京都,青ヶ島村,青ヶ島村,178,201,-23,-11.4427860697,5.96,29.9,125,122,3,2.4590163934
13421,東京都,小笠原村,小笠原村,3023,2785,238,8.5457809695,104.35,29.0,1517,1344,173,12.8720238095
14101,神奈川県,横浜市鶴見区,横浜市 鶴見区,285404,272178,13226,4.8593200038,33.23,8588.7,132833,124177,8656,6.9706950563
14102,神奈川県,横浜市神奈川区,横浜市 神奈川区,239109,233429,5680,2.4332880662,23.73,10076.2,119222,113613,5609,4.9369350338
14103,神奈川県,横浜市西区,横浜市 西区,98554,94867,3687,3.8864937228,7.03,14019.1,51744,49076,2668,5.4364658896
14104,神奈川県,横浜市中区,横浜市 中区,148356,146033,2323,1.5907363404,21.20,6997.9,78836,75700,3136,4.1426684280
14105,神奈川県,横浜市南区,横浜市 南区,194927,196153,-1226,-0.6250223040,12.65,15409.2,95614,92352,3262,3.5321379071
14106,神奈川県,横浜市保土ケ谷区,横浜市 保土ケ谷区,205560,206634,-1074,-0.5197595749,21.93,9373.5,92878,90076,2802,3.1107065145
14107,神奈川県,横浜市磯子区,横浜市 磯子区,166263,163237,3026,1.8537463933,19.05,8727.7,74538,71169,3369,4.7338026388
14108,神奈川県,横浜市金沢区,横浜市 金沢区,202300,209274,-6974,-3.3324732169,30.96,6534.2,86878,86773,105,0.1210053819
14109,神奈川県,横浜市港北区,横浜市 港北区,344261,329471,14790,4.4890142076,31.40,10963.7,163484,154733,8751,5.6555485902
14110,神奈川県,横浜市戸塚区,横浜市 戸塚区,275349,274324,1025,0.3736457619,35.79,7693.5,113347,109824,3523,3.2078598485
14111,神奈川県,横浜市港南区,横浜市 港南区,215775,221411,-5636,-2.5454923197,19.90,10843.0,90993,90108,885,0.9821547476
14112,神奈川県,横浜市旭区,横浜市 旭区,247234,251086,-3852,-1.5341357145,32.73,7553.7,102683,100980,1703,1.6864725688
14113,神奈川県,横浜市緑区,横浜市 緑区,180426,177631,2795,1.5734866099,25.51,7072.8,74418,71204,3214,4.5137913600
14114,神奈川県,横浜市瀬谷区,横浜市 瀬谷区,124626,126913,-2287,-1.8020218575,17.17,7258.4,50484,49560,924,1.8644067797
14115,神奈川県,横浜市栄区,横浜市 栄区,122227,124866,-2639,-2.1134656352,18.52,6599.7,50400,50345,55,0.1092462012
14116,神奈川県,横浜市泉区,横浜市 泉区,154038,155698,-1660,-1.0661665532,23.58,6532.6,60701,58838,1863,3.1663210850
14117,神奈川県,横浜市青葉区,横浜市 青葉区,309859,304297,5562,1.8278195316,35.22,8797.8,125714,120378,5336,4.4327036502
14118,神奈川県,横浜市都筑区,横浜市 都筑区,211899,201271,10628,5.2804427861,27.87,7603.1,80478,74983,5495,7.3283277543
14131,神奈川県,川崎市川崎区,川崎市 川崎区,223440,217328,6112,2.8123389531,39.53,5652.4,109474,105586,3888,3.6823063664
14132,神奈川県,川崎市幸区,川崎市 幸区,160864,154212,6652,4.3135423962,10.01,16070.3,75139,70680,4459,6.3087153367
14133,神奈川県,川崎市中原区,川崎市 中原区,247476,233925,13551,5.7928823341,14.74,16789.4,123312,117190,6122,5.2239952214
14134,神奈川県,川崎市高津区,川崎市 高津区,228119,217360,10759,4.9498527788,16.36,13943.7,107920,101753,6167,6.0607549655
14135,神奈川県,川崎市多摩区,川崎市 多摩区,214240,213894,346,0.1617623683,20.50,10450.7,106390,103595,2795,2.6980066606
14136,神奈川県,川崎市宮前区,川崎市 宮前区,225604,218867,6737,3.0781250714,18.61,12122.7,94754,92164,2590,2.8102078903
14137,神奈川県,川崎市麻生区,川崎市 麻生区,175557,169926,5631,3.3137954168,23.25,7550.8,74247,71726,2521,3.5147645205
14151,神奈川県,相模原市緑区,相模原市 緑区,173710,176192,-2482,-1.4086905194,253.68,684.8,71168,70052,1116,1.5931022669
14152,神奈川県,相模原市中央区,相模原市 中央区,270021,266982,3039,1.1382789851,36.87,7323.6,116294,112483,3811,3.3880675302
14153,神奈川県,相模原市南区,相模原市 南区,277183,274341,2842,1.0359370273,38.11,7273.2,123772,120267,3505,2.9143489070
14201,神奈川県,横須賀市,横須賀市,406686,418325,-11639,-2.7822864997,100.83,4033.4,165755,164362,1393,0.8475194996
14203,神奈川県,平塚市,平塚市,258246,260780,-2534,-0.9717002838,67.82,3807.8,107339,104369,2970,2.8456725656
14204,神奈川県,鎌倉市,鎌倉市,172902,174314,-1412,-0.8100324701,39.66,4359.6,73032,72463,569,0.7852283234
14205,神奈川県,藤沢市,藤沢市,424103,409657,14446,3.5263647393,69.57,6096.1,180180,171981,8199,4.7673870951
14206,神奈川県,小田原市,小田原市,194174,198327,-4153,-2.0940164476,113.79,1706.4,79154,77793,1361,1.7495147378
14207,神奈川県,茅ヶ崎市,茅ヶ崎市,239424,235081,4343,1.8474483263,35.70,6706.6,97944,93445,4499,4.8145968217
14208,神奈川県,逗子市,逗子市,56492,58302,-1810,-3.1045247161,17.28,3269.2,24318,23844,474,1.9879214897
14210,神奈川県,三浦市,三浦市,45302,48352,-3050,-6.3079086698,32.05,1413.5,17563,17884,-321,-1.7949004697
14211,神奈川県,秦野市,秦野市,167387,170145,-2758,-1.6209703488,103.76,1613.2,69616,69373,243,0.3502803684
14212,神奈川県,厚木市,厚木市,225503,224420,1083,0.4825773104,93.84,2403.1,95964,92476,3488,3.7717894373
14213,神奈川県,大和市,大和市,233061,228186,4875,2.1364150298,27.09,8603.2,101971,97244,4727,4.8609682860
14214,神奈川県,伊勢原市,伊勢原市,101575,101039,536,0.5304882273,55.56,1828.2,43075,41184,1891,4.5915889666
14215,神奈川県,海老名市,海老名市,130287,127707,2580,2.0202494773,26.59,4899.8,53402,50405,2997,5.9458387065
14216,神奈川県,座間市,座間市,128651,129436,-785,-0.6064773324,17.57,7322.2,55807,53977,1830,3.3903329196
14217,神奈川県,南足柄市,南足柄市,43328,44020,-692,-1.5720127215,77.12,561.8,16239,15873,366,2.3058023058
14218,神奈川県,綾瀬市,綾瀬市,84520,83167,1353,1.6268471870,22.14,3817.5,33373,31519,1854,5.8821663124
14300,神奈川県,三浦郡,三浦郡,32104,32766,-662,-2.0203869865,17.04,1884.0,12551,12539,12,0.0957014116
14301,神奈川県,葉山町,葉山町,32104,32766,-662,-2.0203869865,17.04,1884.0,12551,12539,12,0.0957014116
14320,神奈川県,高座郡,高座郡,47935,47672,263,0.5516865246,13.34,3593.3,18757,18033,724,4.0148616425
14321,神奈川県,寒川町,寒川町,47935,47672,263,0.5516865246,13.34,3593.3,18757,18033,724,4.0148616425
14340,神奈川県,中郡,中郡,59958,62554,-2596,-4.1500143876,26.25,2284.1,23401,23754,-353,-1.4860655048
14341,神奈川県,大磯町,大磯町,31568,33032,-1464,-4.4320658755,17.18,1837.5,12220,12416,-196,-1.5786082474
14342,神奈川県,二宮町,二宮町,28390,29522,-1132,-3.8344285618,9.08,3126.7,11181,11338,-157,-1.3847239372
14360,神奈川県,足柄上郡,足柄上郡,65625,67791,-2166,-3.1951143957,303.28,216.4,23987,23825,162,0.6799580273
14361,神奈川県,中井町,中井町,9683,10010,-327,-3.2667332667,19.99,484.4,3356,3339,17,0.5091344714
14362,神奈川県,大井町,大井町,17036,17972,-936,-5.2081014912,14.38,1184.7,6175,6350,-175,-2.7559055118
14363,神奈川県,松田町,松田町,11162,11676,-514,-4.4021925317,37.75,295.7,4393,4433,-40,-0.9023234830
14364,神奈川県,山北町,山北町,10723,11764,-1041,-8.8490309419,224.61,47.7,3882,3954,-72,-1.8209408194
14366,神奈川県,開成町,開成町,17021,16369,652,3.9831388600,6.55,2598.6,6181,5749,432,7.5143503218
14380,神奈川県,足柄下郡,足柄下郡,44107,48913,-4806,-9.8256087339,140.87,313.1,19911,21520,-1609,-7.4767657993
14382,神奈川県,箱根町,箱根町,11717,13853,-2136,-15.4190428066,92.86,126.2,6080,7266,-1186,-16.3225984035
14383,神奈川県,真鶴町,真鶴町,7344,8212,-868,-10.5698977107,7.04,1043.2,3066,3252,-186,-5.7195571956
14384,神奈川県,湯河原町,湯河原町,25046,26848,-1802,-6.7118593564,40.97,611.3,10765,11002,-237,-2.1541537902
14400,神奈川県,愛甲郡,愛甲郡,43572,45548,-1976,-4.3382804953,105.52,412.9,17189,17264,-75,-0.4344300278
14401,神奈川県,愛川町,愛川町,40356,42089,-1733,-4.1174653710,34.28,1177.2,16065,16063,2,0.0124509743
14402,神奈川県,清川村,清川村,3216,3459,-243,-7.0251517780,71.24,45.1,1124,1201,-77,-6.4113238968
15101,新潟県,新潟市北区,新潟市 北区,76367,77621,-1254,-1.6155421857,107.72,708.9,27072,26050,1022,3.9232245681
15102,新潟県,新潟市東区,新潟市 東区,137637,138096,-459,-0.3323774765,38.62,3563.9,55516,54447,1069,1.9633772292
15103,新潟県,新潟市中央区,新潟市 中央区,183836,180537,3299,1.8273262545,37.75,4869.8,88453,85405,3048,3.5688777004
15104,新潟県,新潟市江南区,新潟市 江南区,68926,69365,-439,-0.6328840193,75.42,913.9,23671,22963,708,3.0832208335
15105,新潟県,新潟市秋葉区,新潟市 秋葉区,76880,77329,-449,-0.5806359839,95.38,806.0,26910,26141,769,2.9417390306
15106,新潟県,新潟市南区,新潟市 南区,45707,46949,-1242,-2.6454237577,100.91,452.9,14581,14113,468,3.3160915468
15107,新潟県,新潟市西区,新潟市 西区,162911,161264,1647,1.0213066772,94.09,1731.4,66876,65255,1621,2.4841008352
15108,新潟県,新潟市西蒲区,新潟市 西蒲区,58250,60740,-2490,-4.0994402371,176.55,329.9,18356,18159,197,1.0848615012
15202,新潟県,長岡市,長岡市,275246,282674,-7428,-2.6277620156,891.06,308.9,100320,98725,1595,1.6155988858
15204,新潟県,三条市,三条市,99216,102292,-3076,-3.0070777773,431.97,229.7,33179,32467,712,2.1929959651
15205,新潟県,柏崎市,柏崎市,86868,91451,-4583,-5.0114268843,442.03,196.5,33561,34104,-543,-1.5921885996
15206,新潟県,新発田市,新発田市,98635,101202,-2567,-2.5365111361,533.10,185.0,34081,33445,636,1.9016295410
15208,新潟県,小千谷市,小千谷市,36510,38600,-2090,-5.4145077720,155.19,235.3,12170,12267,-97,-0.7907393821
15209,新潟県,加茂市,加茂市,27864,29762,-1898,-6.3772595928,133.72,208.4,9625,9677,-52,-0.5373566188
15210,新潟県,十日町市,十日町市,54932,58911,-3979,-6.7542564207,590.39,93.0,18591,18983,-392,-2.0650055313
15211,新潟県,見附市,見附市,40620,41862,-1242,-2.9668912140,77.91,521.4,13703,13371,332,2.4829855658
15212,新潟県,村上市,村上市,62463,66427,-3964,-5.9674529935,1174.26,53.2,22139,22058,81,0.3672137093
15213,新潟県,燕市,燕市,79814,81876,-2062,-2.5184425228,110.96,719.3,27526,26653,873,3.2754286572
15216,新潟県,糸魚川市,糸魚川市,44161,47702,-3541,-7.4231688399,746.24,59.2,16711,17433,-722,-4.1415705845
15217,新潟県,妙高市,妙高市,33222,35457,-2235,-6.3034097639,445.63,74.6,11597,11801,-204,-1.7286670621
15218,新潟県,五泉市,五泉市,51409,54550,-3141,-5.7580201650,351.91,146.1,16946,16859,87,0.5160448425
15222,新潟県,上越市,上越市,197026,203899,-6873,-3.3707865169,973.81,202.3,71016,71477,-461,-0.6449627153
15223,新潟県,阿賀野市,阿賀野市,43421,45560,-2139,-4.6949078139,192.74,225.3,13389,13154,235,1.7865288125
15224,新潟県,佐渡市,佐渡市,57262,62727,-5465,-8.7123567204,855.61,66.9,22405,23755,-1350,-5.6830141023
15225,新潟県,魚沼市,魚沼市,37370,40361,-2991,-7.4106191621,946.76,39.5,12835,13075,-240,-1.8355640535
15226,新潟県,南魚沼市,南魚沼市,58588,61624,-3036,-4.9266519538,584.55,100.2,19396,19482,-86,-0.4414331177
15227,新潟県,胎内市,胎内市,30209,31424,-1215,-3.8664714868,264.89,114.0,10062,9901,161,1.6260983739
15300,新潟県,北蒲原郡,北蒲原郡,14066,13724,342,2.4919848441,37.58,374.3,4312,3950,362,9.1645569620
15307,新潟県,聖籠町,聖籠町,14066,13724,342,2.4919848441,37.58,374.3,4312,3950,362,9.1645569620
15340,新潟県,西蒲原郡,西蒲原郡,8212,8582,-370,-4.3113493358,25.17,326.3,2597,2586,11,0.4253673627
15342,新潟県,弥彦村,弥彦村,8212,8582,-370,-4.3113493358,25.17,326.3,2597,2586,11,0.4253673627
15360,新潟県,南蒲原郡,南蒲原郡,12196,12791,-595,-4.6517082324,31.71,384.6,4027,4027,0,0.0000000000
15361,新潟県,田上町,田上町,12196,12791,-595,-4.6517082324,31.71,384.6,4027,4027,0,0.0000000000
15380,新潟県,東蒲原郡,東蒲原郡,11683,13303,-1620,-12.1777042772,952.89,12.3,4484,4870,-386,-7.9260780287
15385,新潟県,阿賀町,阿賀町,11683,13303,-1620,-12.1777042772,952.89,12.3,4484,4870,-386,-7.9260780287
15400,新潟県,三島郡,三島郡,4529,4907,-378,-7.7032810271,44.38,102.1,1608,1665,-57,-3.4234234234
15405,新潟県,出雲崎町,出雲崎町,4529,4907,-378,-7.7032810271,44.38,102.1,1608,1665,-57,-3.4234234234
15460,新潟県,南魚沼郡,南魚沼郡,8047,8396,-349,-4.1567413054,357.29,22.5,3455,3463,-8,-0.2310135720
15461,新潟県,湯沢町,湯沢町,8047,8396,-349,-4.1567413054,357.29,22.5,3455,3463,-8,-0.2310135720
15480,新潟県,中魚沼郡,中魚沼郡,10034,10881,-847,-7.7842110100,170.21,59.0,3328,3482,-154,-4.4227455485
15482,新潟県,津南町,津南町,10034,10881,-847,-7.7842110100,170.21,59.0,3328,3482,-154,-4.4227455485
15500,新潟県,刈羽郡,刈羽郡,4776,4800,-24,-0.5000000000,26.27,181.8,1682,1653,29,1.7543859649
15504,新潟県,刈羽村,刈羽村,4776,4800,-24,-0.5000000000,26.27,181.8,1682,1653,29,1.7543859649
15580,新潟県,岩船郡,岩船郡,6205,6804,-599,-8.8036449148,309.40,20.1,2019,2123,-104,-4.8987282148
15581,新潟県,関川村,関川村,5835,6438,-603,-9.3662628145,299.61,19.5,1846,1941,-95,-4.8943843380
15586,新潟県,粟島浦村,粟島浦村,370,366,4,1.0928961749,9.78,37.8,173,182,-9,-4.9450549451
16201,富山県,富山市,富山市,418900,421953,-3053,-0.7235402995,1241.77,337.3,163701,159151,4550,2.8589201450
16202,富山県,高岡市,高岡市,172256,176061,-3805,-2.1611827719,209.57,821.9,63753,61992,1761,2.8406891212
16204,富山県,魚津市,魚津市,42958,44959,-2001,-4.4507217687,200.61,214.1,15856,15924,-68,-0.4270283848
16205,富山県,氷見市,氷見市,48012,51726,-3714,-7.1801415149,230.56,208.2,16089,16458,-369,-2.2420707255
16206,富山県,滑川市,滑川市,32774,33676,-902,-2.6784653759,54.63,599.9,11699,11298,401,3.5493007612
16207,富山県,黒部市,黒部市,41022,41852,-830,-1.9831788206,426.31,96.2,14793,14628,165,1.1279737490
16208,富山県,砺波市,砺波市,49020,49410,-390,-0.7893139041,127.03,385.9,16203,15559,644,4.1390834887
16209,富山県,小矢部市,小矢部市,30416,32067,-1651,-5.1485951289,134.07,226.9,9513,9581,-68,-0.7097380232
16210,富山県,南砺市,南砺市,51350,54724,-3374,-6.1654849792,668.64,76.8,16587,16930,-343,-2.0259893680
16211,富山県,射水市,射水市,92325,93588,-1263,-1.3495319913,109.43,843.7,32048,31246,802,2.5667285413
16320,富山県,中新川郡,中新川郡,50255,52398,-2143,-4.0898507577,547.46,91.8,17408,17296,112,0.6475485661
16321,富山県,舟橋村,舟橋村,2982,2967,15,0.5055611729,3.47,859.4,910,889,21,2.3622047244
16322,富山県,上市町,上市町,20940,21965,-1025,-4.6665149101,236.71,88.5,7392,7415,-23,-0.3101820634
16323,富山県,立山町,立山町,26333,27466,-1133,-4.1251001238,307.29,85.7,9106,8992,114,1.2677935943
16340,富山県,下新川郡,下新川郡,37595,40833,-3238,-7.9298606519,297.55,126.3,13136,13376,-240,-1.7942583732
16342,富山県,入善町,入善町,25358,27182,-1824,-6.7103230079,71.25,355.9,8623,8658,-35,-0.4042504043
16343,富山県,朝日町,朝日町,12237,13651,-1414,-10.3582155153,226.30,54.1,4513,4718,-205,-4.3450614667
17201,石川県,金沢市,金沢市,465810,462361,3449,0.7459539191,468.64,994.0,199604,191256,8348,4.3648303844
17202,石川県,七尾市,七尾市,55348,57900,-2552,-4.4075993092,318.32,173.9,20828,20944,-116,-0.5538579068
17203,石川県,小松市,小松市,106940,108433,-1493,-1.3768871100,371.05,288.2,38157,37470,687,1.8334667734
17204,石川県,輪島市,輪島市,27205,29858,-2653,-8.8853908500,426.32,63.8,10680,11366,-686,-6.0355446067
17205,石川県,珠洲市,珠洲市,14631,16300,-1669,-10.2392638037,247.26,59.2,5867,6228,-361,-5.7964033398
17206,石川県,加賀市,加賀市,67235,71887,-4652,-6.4712674058,305.87,219.8,24840,25966,-1126,-4.3364399599
17207,石川県,羽咋市,羽咋市,21726,23032,-1306,-5.6703716568,81.85,265.4,8066,8085,-19,-0.2350030921
17209,石川県,かほく市,かほく市,34226,34651,-425,-1.2265158293,64.44,531.1,11603,11084,519,4.6824251173
17210,石川県,白山市,白山市,109321,110459,-1138,-1.0302465168,754.93,144.8,38388,36556,1832,5.0114892220
17211,石川県,能美市,能美市,48899,48680,219,0.4498767461,84.14,581.2,17380,15945,1435,8.9996864221
17212,石川県,野々市市,野々市市,55122,51885,3237,6.2387973403,13.56,4065.0,24829,23024,1805,7.8396455872
17320,石川県,能美郡,能美郡,6360,6147,213,3.4651049292,14.64,434.4,1846,1720,126,7.3255813953
17324,石川県,川北町,川北町,6360,6147,213,3.4651049292,14.64,434.4,1846,1720,126,7.3255813953
17360,石川県,河北郡,河北郡,63964,63867,97,0.1518781217,130.92,488.6,23013,21960,1053,4.7950819672
17361,石川県,津幡町,津幡町,36982,36940,42,0.1136978885,110.59,334.4,12552,11942,610,5.1080221068
17365,石川県,内灘町,内灘町,26982,26927,55,0.2042559513,20.33,1327.2,10461,10018,443,4.4220403274
17380,石川県,羽咋郡,羽咋郡,33605,36493,-2888,-7.9138464911,358.28,93.8,11943,12410,-467,-3.7630942788
17384,石川県,志賀町,志賀町,20434,22216,-1782,-8.0212459489,246.76,82.8,7495,7849,-354,-4.5101286788
17386,石川県,宝達志水町,宝達志水町,13171,14277,-1106,-7.7467255026,111.52,118.1,4448,4561,-113,-2.4775268581
17400,石川県,鹿島郡,鹿島郡,17582,18535,-953,-5.1416239547,89.45,196.6,6053,6133,-80,-1.3044187184
17407,石川県,中能登町,中能登町,17582,18535,-953,-5.1416239547,89.45,196.6,6053,6133,-80,-1.3044187184
17460,石川県,鳳珠郡,鳳珠郡,26369,29300,-2931,-10.0034129693,456.48,57.8,10372,11023,-651,-5.9058332577
17461,石川県,穴水町,穴水町,8793,9735,-942,-9.6764252696,183.21,48.0,3464,3659,-195,-5.3293249522
17463,石川県,能登町,能登町,17576,19565,-1989,-10.1661129568,273.27,64.3,6908,7364,-456,-6.1922868007
18201,福井県,福井市,福井市,266002,266796,-794,-0.2976056613,536.41,495.9,99554,97446,2108,2.1632493894
18202,福井県,敦賀市,敦賀市,66187,67760,-1573,-2.3214285714,251.34,263.3,26530,26453,77,0.2910822969
18204,福井県,小浜市,小浜市,29673,31340,-1667,-5.3190810466,233.09,127.3,11238,11477,-239,-2.0824257210
18205,福井県,大野市,大野市,33128,35291,-2163,-6.1290413987,872.43,38.0,10671,10847,-176,-1.6225684521
18206,福井県,勝山市,勝山市,24144,25466,-1322,-5.1912353727,253.88,95.1,7701,7773,-72,-0.9262832883
18207,福井県,鯖江市,鯖江市,68337,67450,887,1.3150481838,84.59,807.9,22324,21028,1296,6.1632109568
18208,福井県,あわら市,あわら市,28756,29989,-1233,-4.1115075528,116.98,245.8,9699,9735,-36,-0.3697996918
18209,福井県,越前市,越前市,81613,85614,-4001,-4.6733010956,230.70,353.8,27881,27601,280,1.0144559980
18210,福井県,坂井市,坂井市,90300,91900,-1600,-1.7410228509,209.67,430.7,29439,28744,695,2.4178959087
18320,福井県,吉田郡,吉田郡,19890,20647,-757,-3.6663922119,94.43,210.6,7295,7217,78,1.0807814882
18322,福井県,永平寺町,永平寺町,19890,20647,-757,-3.6663922119,94.43,210.6,7295,7217,78,1.0807814882
18380,福井県,今立郡,今立郡,2639,3046,-407,-13.3617859488,194.65,13.6,903,1006,-103,-10.2385685885
18382,福井県,池田町,池田町,2639,3046,-407,-13.3617859488,194.65,13.6,903,1006,-103,-10.2385685885
18400,福井県,南条郡,南条郡,10799,11551,-752,-6.5102588520,343.69,31.4,3348,3483,-135,-3.8759689922
18404,福井県,南越前町,南越前町,10799,11551,-752,-6.5102588520,343.69,31.4,3348,3483,-135,-3.8759689922
18420,福井県,丹生郡,丹生郡,21527,23160,-1633,-7.0509499136,153.15,140.6,6581,6728,-147,-2.1848989298
18423,福井県,越前町,越前町,21527,23160,-1633,-7.0509499136,153.15,140.6,6581,6728,-147,-2.1848989298
18440,福井県,三方郡,三方郡,9919,10563,-644,-6.0967528164,152.34,65.1,3915,3879,36,0.9280742459
18442,福井県,美浜町,美浜町,9919,10563,-644,-6.0967528164,152.34,65.1,3915,3879,36,0.9280742459
18480,福井県,大飯郡,大飯郡,18921,19642,-721,-3.6707056308,284.59,66.5,7405,7188,217,3.0189204229
18481,福井県,高浜町,高浜町,10596,11062,-466,-4.2126197794,72.40,146.4,4188,4044,144,3.5608308605
18483,福井県,おおい町,おおい町,8325,8580,-255,-2.9720279720,212.19,39.2,3217,3144,73,2.3218829517
18500,福井県,三方上中郡,三方上中郡,15264,16099,-835,-5.1866575564,178.49,85.5,4896,4994,-98,-1.9623548258
18501,福井県,若狭町,若狭町,15264,16099,-835,-5.1866575564,178.49,85.5,4896,4994,-98,-1.9623548258
19201,山梨県,甲府市,甲府市,193123,198992,-5869,-2.9493647986,212.47,908.9,84522,85101,-579,-0.6803680333
19202,山梨県,富士吉田市,富士吉田市,49024,50619,-1595,-3.1509907347,121.74,402.7,18082,17713,369,2.0832157173
19204,山梨県,都留市,都留市,32014,33588,-1574,-4.6861974515,161.63,198.1,13440,13536,-96,-0.7092198582
19205,山梨県,山梨市,山梨市,35155,36832,-1677,-4.5531059948,289.80,121.3,12890,13039,-149,-1.1427256691
19206,山梨県,大月市,大月市,25437,28120,-2683,-9.5412517781,280.25,90.8,9733,10151,-418,-4.1178209043
19207,山梨県,韮崎市,韮崎市,30672,32477,-1805,-5.5577793515,143.69,213.5,11600,11826,-226,-1.9110434636
19208,山梨県,南アルプス市,南アルプス市,70843,72635,-1792,-2.4671301714,264.14,268.2,24979,24500,479,1.9551020408
19209,山梨県,北杜市,北杜市,45116,46968,-1852,-3.9431102027,602.48,74.9,18407,18281,126,0.6892401947
19210,山梨県,甲斐市,甲斐市,74417,73807,610,0.8264798732,71.95,1034.3,29441,28207,1234,4.3748005814
19211,山梨県,笛吹市,笛吹市,69600,70529,-929,-1.3171886742,201.92,344.7,26259,25500,759,2.9764705882
19212,山梨県,上野原市,上野原市,24812,27114,-2302,-8.4900789260,170.57,145.5,9632,10032,-400,-3.9872408293
19213,山梨県,甲州市,甲州市,31714,33927,-2213,-6.5228284257,264.11,120.1,11409,11588,-179,-1.5447014153
19214,山梨県,中央市,中央市,31139,31322,-183,-0.5842538791,31.69,982.6,12798,12179,619,5.0825190902
19340,山梨県,西八代郡,西八代郡,15663,17111,-1448,-8.4623926129,75.18,208.3,5881,6074,-193,-3.1774777741
19346,山梨県,市川三郷町,市川三郷町,15663,17111,-1448,-8.4623926129,75.18,208.3,5881,6074,-193,-3.1774777741
19360,山梨県,南巨摩郡,南巨摩郡,37104,41026,-3922,-9.5597913518,984.82,37.7,14446,15131,-685,-4.5271297337
19364,山梨県,早川町,早川町,1070,1246,-176,-14.1252006421,369.96,2.9,573,681,-108,-15.8590308370
19365,山梨県,身延町,身延町,12673,14462,-1789,-12.3703498825,301.98,42.0,5198,5593,-395,-7.0623994279
19366,山梨県,南部町,南部町,8071,9011,-940,-10.4316945955,200.87,40.2,3002,3088,-86,-2.7849740933
19368,山梨県,富士川町,富士川町,15290,16307,-1017,-6.2365855154,112.00,136.5,5673,5769,-96,-1.6640665627
19380,山梨県,中巨摩郡,中巨摩郡,19507,17653,1854,10.5024641704,9.08,2148.3,8207,7162,1045,14.5908963977
19384,山梨県,昭和町,昭和町,19507,17653,1854,10.5024641704,9.08,2148.3,8207,7162,1045,14.5908963977
19420,山梨県,南都留郡,南都留郡,48534,48854,-320,-0.6550128956,420.71,115.4,17597,17020,577,3.3901292597
19422,山梨県,道志村,道志村,1743,1919,-176,-9.1714434601,79.68,21.9,590,588,2,0.3401360544
19423,山梨県,西桂町,西桂町,4345,4541,-196,-4.3162299053,15.22,285.5,1472,1443,29,2.0097020097
19424,山梨県,忍野村,忍野村,8974,8635,339,3.9258830342,25.05,358.2,3035,2802,233,8.3154889365
19425,山梨県,山中湖村,山中湖村,5210,5324,-114,-2.1412471826,52.77,98.7,1867,1763,104,5.8990357345
19429,山梨県,鳴沢村,鳴沢村,2921,2964,-43,-1.4507422402,89.58,32.6,1033,1015,18,1.7733990148
19430,山梨県,富士河口湖町,富士河口湖町,25341,25471,-130,-0.5103843587,158.40,160.0,9600,9409,191,2.0299713041
19440,山梨県,北都留郡,北都留郡,1291,1501,-210,-13.9906728847,154.08,8.4,630,681,-51,-7.4889867841
19442,山梨県,小菅村,小菅村,726,816,-90,-11.0294117647,52.78,13.8,337,347,-10,-2.8818443804
19443,山梨県,丹波山村,丹波山村,565,685,-120,-17.5182481752,101.30,5.6,293,334,-41,-12.2754491018
20201,長野県,長野市,長野市,377803,381511,-3708,-0.9719247938,834.81,452.6,150465,146520,3945,2.6924651925
20202,長野県,松本市,松本市,243383,243037,346,0.1423651543,978.47,248.7,100081,97303,2778,2.8549993320
20203,長野県,上田市,上田市,156909,159597,-2688,-1.6842421850,552.04,284.2,62606,60660,1946,3.2080448401
20204,長野県,岡谷市,岡谷市,50146,52841,-2695,-5.1002062792,85.10,589.3,18950,19501,-551,-2.8254961284
20205,長野県,飯田市,飯田市,101676,105335,-3659,-3.4736792139,658.66,154.4,37570,37867,-297,-0.7843240817
20206,長野県,諏訪市,諏訪市,50163,51200,-1037,-2.0253906250,109.17,459.5,20367,20444,-77,-0.3766386226
20207,長野県,須坂市,須坂市,50743,52168,-1425,-2.7315595768,149.67,339.0,18453,18106,347,1.9164917707
20208,長野県,小諸市,小諸市,42536,43997,-1461,-3.3206809555,98.55,431.6,16624,16343,281,1.7193905648
20209,長野県,伊那市,伊那市,68322,71093,-2771,-3.8977114484,667.93,102.3,26263,26112,151,0.5782781863
20210,長野県,駒ヶ根市,駒ヶ根市,32768,33693,-925,-2.7453773781,165.86,197.6,12417,12161,256,2.1050900419
20211,長野県,中野市,中野市,43900,45638,-1738,-3.8082299838,112.18,391.3,15275,15092,183,1.2125629473
20212,長野県,大町市,大町市,28045,29801,-1756,-5.8924197175,565.15,49.6,10822,11054,-232,-2.0987877691
20213,長野県,飯山市,飯山市,21444,23545,-2101,-8.9233382884,202.43,105.9,7374,7694,-320,-4.1590850013
20214,長野県,茅野市,茅野市,55951,56391,-440,-0.7802663546,266.59,209.9,22324,21687,637,2.9372435099
20215,長野県,塩尻市,塩尻市,67170,67670,-500,-0.7388798581,289.98,231.6,26245,25092,1153,4.5950900685
20217,長野県,佐久市,佐久市,99416,100552,-1136,-1.1297637044,423.51,234.7,38487,37032,1455,3.9290343487
20218,長野県,千曲市,千曲市,60317,62068,-1751,-2.8210994393,119.79,503.5,21554,21449,105,0.4895333116
20219,長野県,東御市,東御市,30107,30696,-589,-1.9188167839,112.37,267.9,11007,10801,206,1.9072308120
20220,長野県,安曇野市,安曇野市,95297,96479,-1182,-1.2251370765,331.78,287.2,34694,34185,509,1.4889571449
20300,長野県,南佐久郡,南佐久郡,25700,27712,-2012,-7.2603926097,767.43,33.5,8890,9040,-150,-1.6592920354
20303,長野県,小海町,小海町,4716,5180,-464,-8.9575289575,114.20,41.3,1869,1843,26,1.4107433532
20304,長野県,川上村,川上村,4603,4972,-369,-7.4215607401,209.61,22.0,1202,1336,-134,-10.0299401198
20305,長野県,南牧村,南牧村,3409,3528,-119,-3.3730158730,133.09,25.6,1023,1005,18,1.7910447761
20306,長野県,南相木村,南相木村,1005,1121,-116,-10.3479036574,66.05,15.2,420,433,-13,-3.0023094688
20307,長野県,北相木村,北相木村,775,842,-67,-7.9572446556,56.32,13.8,359,331,28,8.4592145015
20309,長野県,佐久穂町,佐久穂町,11192,12069,-877,-7.2665506670,188.15,59.5,4017,4092,-75,-1.8328445748
20320,長野県,北佐久郡,北佐久郡,41473,41463,10,0.0241178882,281.69,147.2,17024,16377,647,3.9506625145
20321,長野県,軽井沢町,軽井沢町,19005,19018,-13,-0.0683562940,156.03,121.8,8228,8082,146,1.8064835437
20323,長野県,御代田町,御代田町,15197,14738,459,3.1143981544,58.79,258.5,6112,5623,489,8.6964253957
20324,長野県,立科町,立科町,7271,7707,-436,-5.6571947580,66.87,108.7,2684,2672,12,0.4491017964
20340,長野県,小県郡,小県郡,10515,11389,-874,-7.6740714725,240.96,43.6,3971,4031,-60,-1.4884644009
20349,長野県,青木村,青木村,4345,4609,-264,-5.7279236277,57.10,76.1,1557,1563,-6,-0.3838771593
20350,長野県,長和町,長和町,6170,6780,-610,-8.9970501475,183.86,33.6,2414,2468,-54,-2.1880064830
20360,長野県,諏訪郡,諏訪郡,42300,44443,-2143,-4.8219067120,254.89,166.0,15989,16563,-574,-3.4655557568
20361,長野県,下諏訪町,下諏訪町,20236,21532,-1296,-6.0189485417,66.87,302.6,7922,8361,-439,-5.2505681139
20362,長野県,富士見町,富士見町,14494,15338,-844,-5.5026730995,144.76,100.1,5395,5634,-239,-4.2421015264
20363,長野県,原村,原村,7570,7573,-3,-0.0396144196,43.26,175.0,2672,2568,104,4.0498442368
20380,長野県,上伊那郡,上伊那郡,83310,85616,-2306,-2.6934217903,514.61,161.9,30431,29938,493,1.6467365890
20382,長野県,辰野町,辰野町,19785,20909,-1124,-5.3756755464,169.20,116.9,7340,7356,-16,-0.2175095160
20383,長野県,箕輪町,箕輪町,25237,26214,-977,-3.7270160983,85.91,293.8,9239,9112,127,1.3937664618
20384,長野県,飯島町,飯島町,9546,9902,-356,-3.5952332862,86.96,109.8,3317,3242,75,2.3133867983
20385,長野県,南箕輪村,南箕輪村,15070,14543,527,3.6237365055,40.99,367.7,5834,5560,274,4.9280575540
20386,長野県,中川村,中川村,4851,5074,-223,-4.3949546709,77.05,63.0,1574,1576,-2,-0.1269035533
20388,長野県,宮田村,宮田村,8821,8974,-153,-1.7049253399,54.50,161.9,3127,3092,35,1.1319534282
20400,長野県,下伊那郡,下伊那郡,60649,64169,-3520,-5.4855148124,1270.23,47.7,20476,20677,-201,-0.9720945979
20402,長野県,松川町,松川町,13183,13676,-493,-3.6048552208,72.79,181.1,4361,4287,74,1.7261488220
20403,長野県,高森町,高森町,13084,13216,-132,-0.9987893462,45.36,288.4,4244,4157,87,2.0928554246
20404,長野県,阿南町,阿南町,4963,5455,-492,-9.0192483960,123.07,40.3,1736,1793,-57,-3.1790295594
20407,長野県,阿智村,阿智村,6540,7036,-496,-7.0494599204,214.43,30.5,2191,2301,-110,-4.7805302043
20409,長野県,平谷村,平谷村,485,563,-78,-13.8543516874,77.37,6.3,229,229,0,0.0000000000
20410,長野県,根羽村,根羽村,970,1129,-159,-14.0832595217,89.97,10.8,434,450,-16,-3.5555555556
20411,長野県,下條村,下條村,3856,4200,-344,-8.1904761905,38.12,101.2,1154,1189,-35,-2.9436501262
20412,長野県,売木村,売木村,575,656,-81,-12.3475609756,43.43,13.2,270,288,-18,-6.2500000000
20413,長野県,天龍村,天龍村,1363,1657,-294,-17.7429088715,109.44,12.5,659,737,-78,-10.5834464043
20414,長野県,泰阜村,泰阜村,1702,1910,-208,-10.8900523560,64.59,26.4,641,657,-16,-2.4353120244
20415,長野県,喬木村,喬木村,6310,6692,-382,-5.7083084280,66.61,94.7,2029,2058,-29,-1.4091350826
20416,長野県,豊丘村,豊丘村,6594,6819,-225,-3.2996040475,76.79,85.9,2053,2000,53,2.6500000000
20417,長野県,大鹿村,大鹿村,1024,1160,-136,-11.7241379310,248.28,4.1,475,531,-56,-10.5461393597
20420,長野県,木曽郡,木曽郡,28421,31042,-2621,-8.4433992655,1546.15,18.4,11475,11949,-474,-3.9668591514
20422,長野県,上松町,上松町,4673,5245,-572,-10.9056244042,168.42,27.7,1867,2029,-162,-7.9842286841
20423,長野県,南木曽町,南木曽町,4317,4810,-493,-10.2494802495,215.93,20.0,1714,1830,-116,-6.3387978142
20425,長野県,木祖村,木祖村,2926,3134,-208,-6.6368857690,140.50,20.8,1045,1069,-24,-2.2450888681
20429,長野県,王滝村,王滝村,839,965,-126,-13.0569948187,310.82,2.7,399,414,-15,-3.6231884058
20430,長野県,大桑村,大桑村,3832,4145,-313,-7.5512665862,234.47,16.3,1516,1537,-21,-1.3662979831
20432,長野県,木曽町,木曽町,11834,12743,-909,-7.1333281017,476.03,24.9,4934,5070,-136,-2.6824457594
20440,長野県,東筑摩郡,東筑摩郡,22238,23261,-1023,-4.3979192640,268.51,82.8,7667,7605,62,0.8152531229
20446,長野県,麻績村,麻績村,2791,2970,-179,-6.0269360269,34.38,81.2,1024,1011,13,1.2858555885
20448,長野県,生坂村,生坂村,1844,1953,-109,-5.5811571941,39.05,47.2,698,732,-34,-4.6448087432
20450,長野県,山形村,山形村,8403,8425,-22,-0.2611275964,24.98,336.4,2752,2601,151,5.8054594387
20451,長野県,朝日村,朝日村,4467,4741,-274,-5.7793714406,70.62,63.3,1411,1422,-11,-0.7735583685
20452,長野県,筑北村,筑北村,4733,5172,-439,-8.4880123743,99.47,47.6,1782,1839,-57,-3.0995106036
20480,長野県,北安曇郡,北安曇郡,31724,32848,-1124,-3.4218217243,544.50,58.3,11651,11391,260,2.2825037310
20481,長野県,池田町,池田町,9930,10329,-399,-3.8629102527,40.16,247.3,3517,3510,7,0.1994301994
20482,長野県,松川村,松川村,9950,10093,-143,-1.4168235411,47.07,211.4,3496,3386,110,3.2486709982
20485,長野県,白馬村,白馬村,8937,9205,-268,-2.9114611624,189.36,47.2,3471,3245,226,6.9645608629
20486,長野県,小谷村,小谷村,2907,3221,-314,-9.7485253027,267.91,10.9,1167,1250,-83,-6.6400000000
20520,長野県,埴科郡,埴科郡,14866,15730,-864,-5.4926891291,53.64,277.1,5479,5505,-26,-0.4722979110
20521,長野県,坂城町,坂城町,14866,15730,-864,-5.4926891291,53.64,277.1,5479,5505,-26,-0.4722979110
20540,長野県,上高井郡,上高井郡,17733,18635,-902,-4.8403541723,117.68,150.7,5822,5799,23,0.3966201069
20541,長野県,小布施町,小布施町,10704,11072,-368,-3.3236994220,19.12,559.8,3531,3511,20,0.5696382797
20543,長野県,高山村,高山村,7029,7563,-534,-7.0606902023,98.56,71.3,2291,2288,3,0.1311188811
20560,長野県,下高井郡,下高井郡,20572,22470,-1898,-8.4468179795,423.18,48.6,7184,7447,-263,-3.5316234725
20561,長野県,山ノ内町,山ノ内町,12437,13678,-1241,-9.0729638836,265.90,46.8,4463,4666,-203,-4.3506215174
20562,長野県,木島平村,木島平村,4661,4939,-278,-5.6286697712,99.32,46.9,1564,1560,4,0.2564102564
20563,長野県,野沢温泉村,野沢温泉村,3474,3853,-379,-9.8364910459,57.96,59.9,1157,1221,-64,-5.2416052416
20580,長野県,上水内郡,上水内郡,22210,24144,-1934,-8.0102717031,282.41,78.6,8035,8187,-152,-1.8566019299
20583,長野県,信濃町,信濃町,8474,9238,-764,-8.2701883525,149.30,56.8,3170,3247,-77,-2.3714197721
20588,長野県,小川村,小川村,2671,3041,-370,-12.1670503124,58.11,46.0,1095,1152,-57,-4.9479166667
20590,長野県,飯綱町,飯綱町,11065,11865,-800,-6.7425200169,75.00,147.5,3770,3788,-18,-0.4751847941
20600,長野県,下水内郡,下水内郡,1952,2215,-263,-11.8735891648,271.66,7.2,775,849,-74,-8.7161366313
20602,長野県,栄村,栄村,1952,2215,-263,-11.8735891648,271.66,7.2,775,849,-74,-8.7161366313
21201,岐阜県,岐阜市,岐阜市,406866,413136,-6270,-1.5176600442,203.60,1998.4,165128,161718,3410,2.1086088129
21202,岐阜県,大垣市,大垣市,159927,161160,-1233,-0.7650781832,206.57,774.2,60026,58536,1490,2.5454421211
21203,岐阜県,高山市,高山市,89205,92747,-3542,-3.8189914499,2177.61,41.0,32680,32213,467,1.4497252662
21204,岐阜県,多治見市,多治見市,110465,112595,-2130,-1.8917358675,91.25,1210.6,41435,40200,1235,3.0721393035
21205,岐阜県,関市,関市,89176,91418,-2242,-2.4524710670,472.33,188.8,32815,32212,603,1.8719731777
21206,岐阜県,中津川市,中津川市,78920,80910,-1990,-2.4595229267,676.45,116.7,28426,27885,541,1.9401111709
21207,岐阜県,美濃市,美濃市,20767,22629,-1862,-8.2283795130,117.01,177.5,7508,7743,-235,-3.0349993543
21208,岐阜県,瑞浪市,瑞浪市,38746,40387,-1641,-4.0631886498,174.86,221.6,13890,13597,293,2.1548871075
21209,岐阜県,羽島市,羽島市,67357,67197,160,0.2381058678,53.66,1255.3,23949,22707,1242,5.4696789536
21210,岐阜県,恵那市,恵那市,51088,53718,-2630,-4.8959380468,504.24,101.3,18088,18140,-52,-0.2866593164
21211,岐阜県,美濃加茂市,美濃加茂市,55414,54729,685,1.2516216266,74.81,740.7,20483,19801,682,3.4442704914
21212,岐阜県,土岐市,土岐市,57842,60475,-2633,-4.3538652336,116.02,498.6,21018,20760,258,1.2427745665
21213,岐阜県,各務原市,各務原市,144734,145604,-870,-0.5975110574,87.81,1648.3,53421,51961,1460,2.8097996574
21214,岐阜県,可児市,可児市,98731,97436,1295,1.3290775483,87.57,1127.5,37151,34768,2383,6.8540036815
21215,岐阜県,山県市,山県市,27118,29629,-2511,-8.4748050896,221.98,122.2,9633,9731,-98,-1.0070907409
21216,岐阜県,瑞穂市,瑞穂市,54364,51950,2414,4.6467757459,28.19,1928.5,21004,19376,1628,8.4021469860
21217,岐阜県,飛騨市,飛騨市,24708,26732,-2024,-7.5714499476,792.53,31.2,8510,8770,-260,-2.9646522235
21218,岐阜県,本巣市,本巣市,34010,35047,-1037,-2.9588837846,374.65,90.8,11346,11150,196,1.7578475336
21219,岐阜県,郡上市,郡上市,42094,44491,-2397,-5.3876064822,1030.75,40.8,14593,14622,-29,-0.1983312816
21220,岐阜県,下呂市,下呂市,33596,36314,-2718,-7.4847166382,851.21,39.5,12130,12496,-366,-2.9289372599
21221,岐阜県,海津市,海津市,35213,37941,-2728,-7.1901109618,112.03,314.3,11515,11645,-130,-1.1163589523
21300,岐阜県,羽島郡,羽島郡,47379,46613,766,1.6433183876,18.21,2601.8,17728,16811,917,5.4547617631
21302,岐阜県,岐南町,岐南町,24625,23804,821,3.4490001680,7.91,3113.1,9539,8971,568,6.3315126519
21303,岐阜県,笠松町,笠松町,22754,22809,-55,-0.2411328861,10.30,2209.1,8189,7840,349,4.4515306122
21340,岐阜県,養老郡,養老郡,29036,31332,-2296,-7.3279714030,72.29,401.7,9370,9536,-166,-1.7407718121
21341,岐阜県,養老町,養老町,29036,31332,-2296,-7.3279714030,72.29,401.7,9370,9536,-166,-1.7407718121
21360,岐阜県,不破郡,不破郡,34985,36601,-1616,-4.4151799131,106.36,328.9,11986,11965,21,0.1755119097
21361,岐阜県,垂井町,垂井町,27564,28505,-941,-3.3011752324,57.09,482.8,9361,9245,116,1.2547322877
21362,岐阜県,関ケ原町,関ケ原町,7421,8096,-675,-8.3374505929,49.28,150.6,2625,2720,-95,-3.4926470588
21380,岐阜県,安八郡,安八郡,44017,45364,-1347,-2.9693148752,59.26,742.8,14421,14428,-7,-0.0485167729
21381,岐阜県,神戸町,神戸町,19286,20065,-779,-3.8823822577,18.78,1026.9,6572,6511,61,0.9368760559
21382,岐阜県,輪之内町,輪之内町,9976,10028,-52,-0.5185480654,22.33,446.8,3137,3015,122,4.0464344942
21383,岐阜県,安八町,安八町,14755,15271,-516,-3.3789535721,18.16,812.5,4712,4902,-190,-3.8759689922
21400,岐阜県,揖斐郡,揖斐郡,69338,72623,-3285,-4.5233603679,876.43,79.1,22534,22774,-240,-1.0538333187
21401,岐阜県,揖斐川町,揖斐川町,21513,23784,-2271,-9.5484359233,803.44,26.8,7293,7742,-449,-5.7995350039
21403,岐阜県,大野町,大野町,23464,23859,-395,-1.6555597468,34.20,686.1,7369,7231,138,1.9084497303
21404,岐阜県,池田町,池田町,24361,24980,-619,-2.4779823859,38.80,627.9,7872,7801,71,0.9101397257
21420,岐阜県,本巣郡,本巣郡,18172,18395,-223,-1.2122859473,5.18,3508.1,7106,6925,181,2.6137184116
21421,岐阜県,北方町,北方町,18172,18395,-223,-1.2122859473,5.18,3508.1,7106,6925,181,2.6137184116
21500,岐阜県,加茂郡,加茂郡,49536,53043,-3507,-6.6116169900,615.10,80.5,17597,17747,-150,-0.8452132755
21501,岐阜県,坂祝町,坂祝町,8206,8361,-155,-1.8538452338,12.87,637.6,3107,3083,24,0.7784625365
21502,岐阜県,富加町,富加町,5566,5516,50,0.9064539521,16.82,330.9,1833,1741,92,5.2843193567
21503,岐阜県,川辺町,川辺町,10200,10593,-393,-3.7099971679,41.16,247.8,3559,3507,52,1.4827487881
21504,岐阜県,七宗町,七宗町,3879,4484,-605,-13.4924174844,90.47,42.9,1381,1457,-76,-5.2161976664
21505,岐阜県,八百津町,八百津町,11029,12045,-1016,-8.4350352844,128.79,85.6,3893,3999,-106,-2.6506626657
21506,岐阜県,白川町,白川町,8395,9530,-1135,-11.9097586569,237.90,35.3,3009,3123,-114,-3.6503362152
21507,岐阜県,東白川村,東白川村,2261,2514,-253,-10.0636435959,87.09,26.0,815,837,-22,-2.6284348865
21520,岐阜県,可児郡,可児郡,18119,18824,-705,-3.7452188695,56.69,319.6,6530,6333,197,3.1106900363
21521,岐阜県,御嵩町,御嵩町,18119,18824,-705,-3.7452188695,56.69,319.6,6530,6333,197,3.1106900363
21600,岐阜県,大野郡,大野郡,1610,1733,-123,-7.0975187536,356.64,4.5,553,601,-48,-7.9866888519
21604,岐阜県,白川村,白川村,1610,1733,-123,-7.0975187536,356.64,4.5,553,601,-48,-7.9866888519
22101,静岡県,静岡市葵区,静岡市 葵区,253677,255375,-1698,-0.6649045521,1073.76,236.3,101541,98767,2774,2.8086304130
22102,静岡県,静岡市駿河区,静岡市 駿河区,212490,213059,-569,-0.2670621753,73.05,2908.8,90533,87433,3100,3.5455720380
22103,静岡県,静岡市清水区,静岡市 清水区,239071,247763,-8692,-3.5081912957,265.09,901.8,93581,92819,762,0.8209526067
22131,静岡県,浜松市中区,浜松市 中区,237479,238477,-998,-0.4184889947,44.34,5355.9,106041,103707,2334,2.2505713211
22132,静岡県,浜松市東区,浜松市 東区,128599,126609,1990,1.5717681997,46.29,2778.1,50105,47647,2458,5.1587718010
22133,静岡県,浜松市西区,浜松市 西区,111400,113654,-2254,-1.9832122055,114.71,971.1,38746,38359,387,1.0088896999
22134,静岡県,浜松市南区,浜松市 南区,100911,102381,-1470,-1.4358132857,46.84,2154.4,38237,37517,720,1.9191299944
22135,静岡県,浜松市北区,浜松市 北区,93624,94680,-1056,-1.1153358682,295.54,316.8,32061,31430,631,2.0076360165
22136,静岡県,浜松市浜北区,浜松市 浜北区,95938,91108,4830,5.3014005356,66.50,1442.7,32486,29695,2791,9.3988887018
22137,静岡県,浜松市天竜区,浜松市 天竜区,30301,33957,-3656,-10.7665577053,943.84,32.1,11424,12089,-665,-5.5008685582
22203,静岡県,沼津市,沼津市,195642,202304,-6662,-3.2930639038,186.96,1046.4,80659,79616,1043,1.3100381833
22205,静岡県,熱海市,熱海市,37570,39611,-2041,-5.1526091237,61.78,608.1,18879,19740,-861,-4.3617021277
22206,静岡県,三島市,三島市,110030,111838,-1808,-1.6166240455,62.02,1774.1,45148,44620,528,1.1833258628
22207,静岡県,富士宮市,富士宮市,130789,132001,-1212,-0.9181748623,389.08,336.1,48941,46988,1953,4.1563803524
22208,静岡県,伊東市,伊東市,68325,71437,-3112,-4.3562859583,124.10,550.6,30413,30636,-223,-0.7279018149
22209,静岡県,島田市,島田市,98136,100276,-2140,-2.1341098568,315.70,310.9,34108,33280,828,2.4879807692
22210,静岡県,富士市,富士市,248381,254027,-5646,-2.2225983852,244.95,1014.0,92523,90980,1543,1.6959771378
22211,静岡県,磐田市,磐田市,167260,168625,-1365,-0.8094885100,163.45,1023.3,61257,59414,1843,3.1019625004
22212,静岡県,焼津市,焼津市,139513,143249,-3736,-2.6080461295,70.31,1984.3,50156,49299,857,1.7383719751
22213,静岡県,掛川市,掛川市,114683,116363,-1680,-1.4437578956,265.69,431.6,41040,39497,1543,3.9066258197
22214,静岡県,藤枝市,藤枝市,143658,142151,1507,1.0601402734,194.06,740.3,51712,49658,2054,4.1362922389
22215,静岡県,御殿場市,御殿場市,88084,89030,-946,-1.0625631810,194.90,451.9,31570,31403,167,0.5317963252
22216,静岡県,袋井市,袋井市,85785,84846,939,1.1067109823,108.33,791.9,31430,29791,1639,5.5016615756
22219,静岡県,下田市,下田市,22926,25013,-2087,-8.3436612961,104.71,218.9,10376,10794,-418,-3.8725217714
22220,静岡県,裾野市,裾野市,52737,54546,-1809,-3.3164668353,138.12,381.8,20772,21042,-270,-1.2831479897
22221,静岡県,湖西市,湖西市,59817,60107,-290,-0.4824729233,86.56,691.0,22408,21619,789,3.6495675101
22222,静岡県,伊豆市,伊豆市,31335,34202,-2867,-8.3825507280,363.97,86.1,12134,12583,-449,-3.5683064452
22223,静岡県,御前崎市,御前崎市,32572,34700,-2128,-6.1325648415,65.56,496.8,11328,11494,-166,-1.4442317731
22224,静岡県,菊川市,菊川市,46770,47041,-271,-0.5760931953,94.19,496.5,16213,15485,728,4.7013238618
22225,静岡県,伊豆の国市,伊豆の国市,48152,49269,-1117,-2.2671456697,94.62,508.9,18651,18742,-91,-0.4855404973
22226,静岡県,牧之原市,牧之原市,45547,49019,-3472,-7.0829678288,111.69,407.8,15389,15607,-218,-1.3968091241
22300,静岡県,賀茂郡,賀茂郡,43516,48700,-5184,-10.6447638604,479.84,90.7,18510,19775,-1265,-6.3969658660
22301,静岡県,東伊豆町,東伊豆町,12627,14064,-1437,-10.2175767918,77.86,162.2,5636,5988,-352,-5.8784235137
22302,静岡県,河津町,河津町,7307,7998,-691,-8.6396599150,100.74,72.5,2908,3029,-121,-3.9947177286
22304,静岡県,南伊豆町,南伊豆町,8511,9516,-1005,-10.5611601513,110.49,77.0,3464,3710,-246,-6.6307277628
22305,静岡県,松崎町,松崎町,6837,7653,-816,-10.6624852999,85.21,80.2,2832,3018,-186,-6.1630218688
22306,静岡県,西伊豆町,西伊豆町,8234,9469,-1235,-13.0425599324,105.54,78.0,3670,4030,-360,-8.9330024814
22320,静岡県,田方郡,田方郡,37657,38571,-914,-2.3696559591,65.16,577.9,14281,13993,288,2.0581719431
22325,静岡県,函南町,函南町,37657,38571,-914,-2.3696559591,65.16,577.9,14281,13993,288,2.0581719431
22340,静岡県,駿東郡,駿東郡,93955,93694,261,0.2785663970,171.46,548.0,35206,34256,950,2.7732368052
22341,静岡県,清水町,清水町,32118,32302,-184,-0.5696241719,8.81,3645.6,12355,12180,175,1.4367816092
22342,静岡県,長泉町,長泉町,42321,40763,1558,3.8220935652,26.63,1589.2,16417,15512,905,5.8341928829
22344,静岡県,小山町,小山町,19516,20629,-1113,-5.3953172718,136.02,143.5,6434,6564,-130,-1.9804996953
22420,静岡県,榛原郡,榛原郡,36311,37889,-1578,-4.1647971707,517.61,70.2,13087,13239,-152,-1.1481229700
22424,静岡県,吉田町,吉田町,29113,29815,-702,-2.3545195371,20.73,1404.4,10212,10253,-41,-0.3998829611
22429,静岡県,川根本町,川根本町,7198,8074,-876,-10.8496408224,496.88,14.5,2875,2986,-111,-3.7173476222
22460,静岡県,周智郡,周智郡,18540,19435,-895,-4.6050939028,133.91,138.5,6131,6126,5,0.0816193275
22461,静岡県,森町,森町,18540,19435,-895,-4.6050939028,133.91,138.5,6131,6126,5,0.0816193275
23101,愛知県,名古屋市千種区,名古屋市 千種区,164499,160015,4484,2.8022372903,18.18,9048.3,85099,80411,4688,5.8300481277
23102,愛知県,名古屋市東区,名古屋市 東区,78079,73272,4807,6.5604869527,7.71,10127.0,41279,38562,2717,7.0457963799
23103,愛知県,名古屋市北区,名古屋市 北区,163585,165785,-2200,-1.3270199355,17.53,9331.7,75340,74641,699,0.9364826302
23104,愛知県,名古屋市西区,名古屋市 西区,149149,144995,4154,2.8649263768,17.93,8318.4,69929,66133,3796,5.7399482860
23105,愛知県,名古屋市中村区,名古屋市 中村区,133275,136164,-2889,-2.1217061778,16.30,8176.4,66040,68877,-2837,-4.1189366552
23106,愛知県,名古屋市中区,名古屋市 中区,83210,78353,4857,6.1988692201,9.38,8871.0,53430,50000,3430,6.8600000000
23107,愛知県,名古屋市昭和区,名古屋市 昭和区,107200,105536,1664,1.5767131595,10.94,9798.9,55234,53782,1452,2.6997880332
23108,愛知県,名古屋市瑞穂区,名古屋市 瑞穂区,105384,105061,323,0.3074404394,11.22,9392.5,48707,47826,881,1.8420942584
23109,愛知県,名古屋市熱田区,名古屋市 熱田区,65903,64719,1184,1.8294473030,8.20,8037.0,31819,30098,1721,5.7179879062
23110,愛知県,名古屋市中川区,名古屋市 中川区,220301,221521,-1220,-0.5507378533,32.02,6880.1,95271,92639,2632,2.8411360226
23111,愛知県,名古屋市港区,名古屋市 港区,146789,149215,-2426,-1.6258419060,45.63,3216.9,61540,59274,2266,3.8229240476
23112,愛知県,名古屋市南区,名古屋市 南区,136992,141310,-4318,-3.0556931569,18.46,7421.0,61208,61757,-549,-0.8889680522
23113,愛知県,名古屋市守山区,名古屋市 守山区,172899,168551,4348,2.5796346506,34.01,5083.8,69616,67087,2529,3.7697318407
23114,愛知県,名古屋市緑区,名古屋市 緑区,241898,229592,12306,5.3599428552,37.91,6380.8,95179,87672,7507,8.5625969523
23115,愛知県,名古屋市名東区,名古屋市 名東区,164119,161012,3107,1.9296698383,19.45,8438.0,73925,71894,2031,2.8249923498
23116,愛知県,名古屋市天白区,名古屋市 天白区,162732,158793,3939,2.4805879352,21.58,7540.9,74320,70574,3746,5.3079037606
23201,愛知県,豊橋市,豊橋市,374883,376665,-1782,-0.4730994385,261.86,1431.6,144040,141424,2616,1.8497567598
23202,愛知県,岡崎市,岡崎市,381031,372357,8674,2.3294848761,387.20,984.1,147267,138255,9012,6.5183899316
23203,愛知県,一宮市,一宮市,379954,378566,1388,0.3666467670,113.82,3338.2,142312,135837,6475,4.7667424928
23204,愛知県,瀬戸市,瀬戸市,129125,132224,-3099,-2.3437500000,111.40,1159.1,50295,50289,6,0.0119310386
23205,愛知県,半田市,半田市,116936,118828,-1892,-1.5922173225,47.42,2466.0,46223,44869,1354,3.0176736722
23206,愛知県,春日井市,春日井市,306599,305569,1030,0.3370760777,92.78,3304.6,124202,119187,5015,4.2076736557
23207,愛知県,豊川市,豊川市,182530,181928,602,0.3309001363,161.14,1132.7,67889,64904,2985,4.5991002095
23208,愛知県,津島市,津島市,63471,65258,-1787,-2.7383615802,25.09,2529.7,23828,23509,319,1.3569271343
23209,愛知県,碧南市,碧南市,71362,72018,-656,-0.9108833903,37.17,1919.9,26442,25265,1177,4.6586186424
23210,愛知県,刈谷市,刈谷市,149810,145781,4029,2.7637346431,50.39,2973.0,62416,58917,3499,5.9388631465
23211,愛知県,豊田市,豊田市,422780,421487,1293,0.3067710273,918.32,460.4,169488,162065,7423,4.5802610064
23212,愛知県,安城市,安城市,184163,178691,5472,3.0622695043,86.05,2140.2,70718,66707,4011,6.0128622184
23213,愛知県,西尾市,西尾市,168045,165298,2747,1.6618470883,161.22,1042.3,58882,54435,4447,8.1693763204
23214,愛知県,蒲郡市,蒲郡市,81150,82249,-1099,-1.3361864582,56.89,1426.4,29903,28864,1039,3.5996396896
23215,愛知県,犬山市,犬山市,74319,75198,-879,-1.1689140669,74.90,992.2,28200,27359,841,3.0739427611
23216,愛知県,常滑市,常滑市,56560,54858,1702,3.1025556892,55.89,1012.0,22492,20769,1723,8.2960181039
23217,愛知県,江南市,江南市,98359,99730,-1371,-1.3747117216,30.20,3256.9,37101,35768,1333,3.7267949005
23219,愛知県,小牧市,小牧市,149540,147132,2408,1.6366256151,62.81,2380.8,59242,55783,3459,6.2008138680
23220,愛知県,稲沢市,稲沢市,136969,136358,611,0.4480851875,79.35,1726.1,49864,47500,2364,4.9768421053
23221,愛知県,新城市,新城市,47150,49864,-2714,-5.4428044280,499.23,94.4,16438,16430,8,0.0486914181
23222,愛知県,東海市,東海市,111988,107690,4298,3.9910855233,43.43,2578.6,46349,42859,3490,8.1429804708
23223,愛知県,大府市,大府市,89170,85249,3921,4.5994674424,33.66,2649.1,35669,33484,2185,6.5255047187
23224,愛知県,知多市,知多市,84643,84768,-125,-0.1474613062,45.90,1844.1,32985,31263,1722,5.5081086268
23225,愛知県,知立市,知立市,70494,68398,2096,3.0644170882,16.31,4322.1,29269,27882,1387,4.9745355426
23226,愛知県,尾張旭市,尾張旭市,80812,81140,-328,-0.4042395859,21.03,3842.7,31787,31009,778,2.5089490148
23227,愛知県,高浜市,高浜市,46252,44027,2225,5.0537170373,13.11,3528.0,17637,16090,1547,9.6146674953
23228,愛知県,岩倉市,岩倉市,47563,47340,223,0.4710604140,10.47,4542.8,20365,18963,1402,7.3933449349
23229,愛知県,豊明市,豊明市,69119,69745,-626,-0.8975553803,23.22,2976.7,27475,26872,603,2.2439714201
23230,愛知県,日進市,日進市,88010,84237,3773,4.4790294051,34.91,2521.1,34179,33418,761,2.2772158717
23231,愛知県,田原市,田原市,62407,64119,-1712,-2.6700354029,191.12,326.5,21433,21145,288,1.3620241192
23232,愛知県,愛西市,愛西市,63119,64978,-1859,-2.8609683277,66.70,946.3,21111,20747,364,1.7544705259
23233,愛知県,清須市,清須市,67393,65841,1552,2.3571938458,17.35,3884.3,27045,25381,1664,6.5560852606
23234,愛知県,北名古屋市,北名古屋市,84153,81571,2582,3.1653406235,18.37,4581.0,33665,31820,1845,5.7982401006
23235,愛知県,弥富市,弥富市,43275,43272,3,0.0069328896,48.99,883.3,16039,15041,998,6.6351971279
23236,愛知県,みよし市,みよし市,61795,60098,1697,2.8237212553,32.19,1919.7,22511,21054,1457,6.9203001805
23237,愛知県,あま市,あま市,86904,86714,190,0.2191111009,27.49,3161.3,33200,31355,1845,5.8842289906
23238,愛知県,長久手市,長久手市,57593,52022,5571,10.7089308370,21.55,2672.5,25008,22240,2768,12.4460431655
23300,愛知県,愛知郡,愛知郡,42872,41851,1021,2.4396071778,18.03,2377.8,15750,14935,815,5.4569802477
23302,愛知県,東郷町,東郷町,42872,41851,1021,2.4396071778,18.03,2377.8,15750,14935,815,5.4569802477
23340,愛知県,西春日井郡,西春日井郡,15183,14405,778,5.4009024644,6.18,2456.8,6181,5776,405,7.0117728532
23342,愛知県,豊山町,豊山町,15183,14405,778,5.4009024644,6.18,2456.8,6181,5776,405,7.0117728532
23360,愛知県,丹羽郡,丹羽郡,57087,56004,1083,1.9337904435,24.80,2301.9,20969,19884,1085,5.4566485617
23361,愛知県,大口町,大口町,23279,22446,833,3.7111289317,13.61,1710.4,8309,7723,586,7.5877249773
23362,愛知県,扶桑町,扶桑町,33808,33558,250,0.7449788426,11.19,3021.3,12660,12161,499,4.1032809802
23420,愛知県,海部郡,海部郡,72486,71104,1382,1.9436318632,40.10,1807.6,28300,26651,1649,6.1873850887
23424,愛知県,大治町,大治町,30999,29891,1108,3.7068013783,6.59,4703.9,12100,11285,815,7.2219760744
23425,愛知県,蟹江町,蟹江町,37087,36688,399,1.0875490624,11.09,3344.2,14941,14078,863,6.1301321210
23427,愛知県,飛島村,飛島村,4400,4525,-125,-2.7624309392,22.42,196.3,1259,1288,-29,-2.2515527950
23440,愛知県,知多郡,知多郡,161794,163401,-1607,-0.9834701134,165.43,978.0,61154,59627,1527,2.5609203884
23441,愛知県,阿久比町,阿久比町,27767,25466,2301,9.0355768476,23.80,1166.7,9625,8518,1107,12.9960084527
23442,愛知県,東浦町,東浦町,49238,49800,-562,-1.1285140562,31.14,1581.2,18504,18020,484,2.6859045505
23445,愛知県,南知多町,南知多町,18714,20549,-1835,-8.9298749331,38.37,487.7,6985,7197,-212,-2.9456718077
23446,愛知県,美浜町,美浜町,23591,25178,-1587,-6.3031217730,46.20,510.6,9329,9700,-371,-3.8247422680
23447,愛知県,武豊町,武豊町,42484,42408,76,0.1792114695,25.92,1639.0,16711,16192,519,3.2052865613
23500,愛知県,額田郡,額田郡,39571,37930,1641,4.3263907197,56.72,697.7,13682,12697,985,7.7577380484
23501,愛知県,幸田町,幸田町,39571,37930,1641,4.3263907197,56.72,697.7,13682,12697,985,7.7577380484
23560,愛知県,北設楽郡,北設楽郡,9661,10862,-1201,-11.0568955993,553.20,17.5,3940,4246,-306,-7.2067828545
23561,愛知県,設楽町,設楽町,5077,5769,-692,-11.9951464725,273.94,18.5,2015,2194,-179,-8.1586144029
23562,愛知県,東栄町,東栄町,3448,3757,-309,-8.2246473250,123.38,27.9,1435,1497,-62,-4.1416165665
23563,愛知県,豊根村,豊根村,1136,1336,-200,-14.9700598802,155.88,7.3,490,555,-65,-11.7117117117
24201,三重県,津市,津市,280016,285746,-5730,-2.0052774142,711.11,393.8,114589,113092,1497,1.3237010575
24202,三重県,四日市市,四日市市,311089,307766,3323,1.0797164079,206.44,1506.9,128239,120020,8219,6.8480253291
24203,三重県,伊勢市,伊勢市,127868,130271,-2403,-1.8446162231,208.35,613.7,50936,49361,1575,3.1907781447
24204,三重県,松阪市,松阪市,163912,168017,-4105,-2.4432051519,623.64,262.8,63933,63611,322,0.5062017576
24205,三重県,桑名市,桑名市,140226,140290,-64,-0.0456197876,136.68,1025.9,53431,51525,1906,3.6991751577
24207,三重県,鈴鹿市,鈴鹿市,196251,199293,-3042,-1.5263958092,194.46,1009.2,77453,75868,1585,2.0891548479
24208,三重県,名張市,名張市,78807,80284,-1477,-1.8397189976,129.77,607.3,30381,29481,900,3.0528136766
24209,三重県,尾鷲市,尾鷲市,18015,20033,-2018,-10.0733789248,192.71,93.5,8652,9219,-567,-6.1503416856
24210,三重県,亀山市,亀山市,50265,51023,-758,-1.4856045313,191.04,263.1,19951,19213,738,3.8411492219
24211,三重県,鳥羽市,鳥羽市,19455,21435,-1980,-9.2372288314,107.34,181.2,7664,8057,-393,-4.8777460593
24212,三重県,熊野市,熊野市,17322,19662,-2340,-11.9011290815,373.35,46.4,8165,9008,-843,-9.3583481350
24214,三重県,いなべ市,いなべ市,45821,45684,137,0.2998861746,219.83,208.4,17030,15972,1058,6.6240921613
24215,三重県,志摩市,志摩市,50360,54694,-4334,-7.9240867371,178.94,281.4,20044,20553,-509,-2.4765241084
24216,三重県,伊賀市,伊賀市,90377,97207,-6830,-7.0262429660,558.23,161.9,33585,34915,-1330,-3.8092510382
24300,三重県,桑名郡,桑名郡,6360,6855,-495,-7.2210065646,15.74,404.1,2170,2250,-80,-3.5555555556
24303,三重県,木曽岬町,木曽岬町,6360,6855,-495,-7.2210065646,15.74,404.1,2170,2250,-80,-3.5555555556
24320,三重県,員弁郡,員弁郡,25350,25661,-311,-1.2119558864,22.68,1117.7,8827,8580,247,2.8787878788
24324,三重県,東員町,東員町,25350,25661,-311,-1.2119558864,22.68,1117.7,8827,8580,247,2.8787878788
24340,三重県,三重郡,三重郡,65518,63607,1911,3.0043863097,121.73,538.2,24148,22558,1590,7.0484972072
24341,三重県,菰野町,菰野町,40208,39978,230,0.5753164240,107.01,375.7,14297,13568,729,5.3729363208
24343,三重県,朝日町,朝日町,10563,9626,937,9.7340536048,5.99,1763.4,3835,3389,446,13.1602242549
24344,三重県,川越町,川越町,14747,14003,744,5.3131471827,8.73,1689.2,6016,5601,415,7.4093911801
24440,三重県,多気郡,多気郡,47041,48687,-1646,-3.3807792635,506.96,92.8,16541,16606,-65,-0.3914247862
24441,三重県,多気町,多気町,14893,15438,-545,-3.5302500324,103.06,144.5,5142,5278,-136,-2.5767336112
24442,三重県,明和町,明和町,22589,22833,-244,-1.0686287391,41.04,550.4,7612,7422,190,2.5599568849
24443,三重県,大台町,大台町,9559,10416,-857,-8.2277265745,362.86,26.3,3787,3906,-119,-3.0465949821
24460,三重県,度会郡,度会郡,45479,48626,-3147,-6.4718463374,651.10,69.8,16949,17507,-558,-3.1872965100
24461,三重県,玉城町,玉城町,15439,15297,142,0.9282865921,40.91,377.4,5236,5064,172,3.3965244866
24470,三重県,度会町,度会町,8312,8692,-380,-4.3718361712,134.98,61.6,2604,2605,-1,-0.0383877159
24471,三重県,大紀町,大紀町,8942,9846,-904,-9.1813934593,233.32,38.3,3691,3912,-221,-5.6492842536
24472,三重県,南伊勢町,南伊勢町,12786,14791,-2005,-13.5555405314,241.89,52.9,5418,5926,-508,-8.5723928451
24540,三重県,北牟婁郡,北牟婁郡,16343,18611,-2268,-12.1863414110,256.53,63.7,7262,8088,-826,-10.2126607319
24543,三重県,紀北町,紀北町,16343,18611,-2268,-12.1863414110,256.53,63.7,7262,8088,-826,-10.2126607319
24560,三重県,南牟婁郡,南牟婁郡,19952,21272,-1320,-6.2053403535,167.75,118.9,8809,9123,-314,-3.4418502686
24561,三重県,御浜町,御浜町,8746,9376,-630,-6.7192832765,88.13,99.2,3862,4000,-138,-3.4500000000
24562,三重県,紀宝町,紀宝町,11206,11896,-690,-5.8002689980,79.62,140.7,4947,5123,-176,-3.4354870193
25201,滋賀県,大津市,大津市,340972,337634,3338,0.9886445086,464.51,734.0,136202,130335,5867,4.5014769632
25202,滋賀県,彦根市,彦根市,113819,112156,1663,1.4827561611,196.87,578.1,45624,43896,1728,3.9365773647
25203,滋賀県,長浜市,長浜市,118230,124131,-5901,-4.7538487566,681.02,173.6,41757,43015,-1258,-2.9245611996
25204,滋賀県,近江八幡市,近江八幡市,81225,81738,-513,-0.6276150628,177.45,457.7,29729,28617,1112,3.8858021456
25206,滋賀県,草津市,草津市,137327,130874,6453,4.9306967006,67.82,2024.9,60206,57318,2888,5.0385568233
25207,滋賀県,守山市,守山市,79837,76560,3277,4.2803030303,55.74,1432.3,28975,26819,2156,8.0390767739
25208,滋賀県,栗東市,栗東市,66764,63655,3109,4.8841410730,52.69,1267.1,24582,22614,1968,8.7025736270
25209,滋賀県,甲賀市,甲賀市,90927,92704,-1777,-1.9168536417,481.62,188.8,32329,31074,1255,4.0387462187
25210,滋賀県,野洲市,野洲市,49893,49955,-62,-0.1241117005,80.14,622.6,18136,17476,660,3.7766079194
25211,滋賀県,湖南市,湖南市,54289,54614,-325,-0.5950855092,70.40,771.2,21256,20463,793,3.8752871036
25212,滋賀県,高島市,高島市,50019,52486,-2467,-4.7003010327,693.05,72.2,18141,18132,9,0.0496360026
25213,滋賀県,東近江市,東近江市,114220,115479,-1259,-1.0902415158,388.37,294.1,40648,38941,1707,4.3835546083
25214,滋賀県,米原市,米原市,38738,40060,-1322,-3.3000499251,250.39,154.7,13232,12952,280,2.1618282891
25380,滋賀県,蒲生郡,蒲生郡,34322,35786,-1464,-4.0909853015,162.15,211.7,11959,12091,-132,-1.0917211149
25383,滋賀県,日野町,日野町,21882,22870,-988,-4.3200699606,117.60,186.1,7697,7678,19,0.2474602761
25384,滋賀県,竜王町,竜王町,12440,12916,-476,-3.6853515020,44.55,279.2,4262,4413,-151,-3.4217085883
25420,滋賀県,愛知郡,愛知郡,20782,20118,664,3.3005268913,37.97,547.3,7213,6761,452,6.6854015678
25425,滋賀県,愛荘町,愛荘町,20782,20118,664,3.3005268913,37.97,547.3,7213,6761,452,6.6854015678
25440,滋賀県,犬上郡,犬上郡,21820,22827,-1007,-4.4114425899,157.20,138.8,7305,7244,61,0.8420762010
25441,滋賀県,豊郷町,豊郷町,7424,7566,-142,-1.8768173407,7.80,951.8,2603,2541,62,2.4399842582
25442,滋賀県,甲良町,甲良町,7036,7500,-464,-6.1866666667,13.63,516.2,2292,2320,-28,-1.2068965517
25443,滋賀県,多賀町,多賀町,7360,7761,-401,-5.1668599407,135.77,54.2,2410,2383,27,1.1330255980
26101,京都府,京都市北区,京都市 北区,119537,122037,-2500,-2.0485590436,94.88,1259.9,56885,56406,479,0.8492004397
26102,京都府,京都市上京区,京都市 上京区,84939,83264,1675,2.0116737125,7.03,12082.4,46745,43389,3356,7.7346792966
26103,京都府,京都市左京区,京都市 左京区,168435,168802,-367,-0.2174144856,246.77,682.6,83467,82067,1400,1.7059232091
26104,京都府,京都市中京区,京都市 中京区,109305,105306,3999,3.7975044157,7.41,14751.0,59194,55772,3422,6.1356953310
26105,京都府,京都市東山区,京都市 東山区,38905,40528,-1623,-4.0046387683,7.48,5201.2,21393,21114,279,1.3213981245
26106,京都府,京都市下京区,京都市 下京区,82775,79287,3488,4.3992079408,6.78,12208.7,47257,43651,3606,8.2609791299
26107,京都府,京都市南区,京都市 南区,99859,98744,1115,1.1291825326,15.81,6316.2,47186,45036,2150,4.7739586109
26108,京都府,京都市右京区,京都市 右京区,204171,202943,1228,0.6050960122,292.07,699.0,94386,90808,3578,3.9401814818
26109,京都府,京都市伏見区,京都市 伏見区,280663,284085,-3422,-1.2045690550,61.66,4551.8,125286,123597,1689,1.3665380228
26110,京都府,京都市山科区,京都市 山科区,135192,136045,-853,-0.6269984196,28.70,4710.5,60492,58321,2171,3.7225013289
26111,京都府,京都市西京区,京都市 西京区,150789,152974,-2185,-1.4283473008,59.24,2545.4,63467,61420,2047,3.3327906219
26201,京都府,福知山市,福知山市,78956,79652,-696,-0.8738010345,552.54,142.9,32141,30890,1251,4.0498543218
26202,京都府,舞鶴市,舞鶴市,84016,88669,-4653,-5.2476062660,342.10,245.6,34702,35504,-802,-2.2589004056
26203,京都府,綾部市,綾部市,33835,35836,-2001,-5.5837705101,347.10,97.5,13738,14006,-268,-1.9134656576
26204,京都府,宇治市,宇治市,184726,189609,-4883,-2.5752996957,67.54,2735.1,73572,72907,665,0.9121209212
26205,京都府,宮津市,宮津市,18427,19948,-1521,-7.6248245438,172.73,106.7,7769,8180,-411,-5.0244498778
26206,京都府,亀岡市,亀岡市,89492,92399,-2907,-3.1461379452,224.80,398.1,33928,33625,303,0.9011152416
26207,京都府,城陽市,城陽市,76884,80037,-3153,-3.9394280145,32.71,2350.5,29873,29972,-99,-0.3303082877
26208,京都府,向日市,向日市,53388,54328,-940,-1.7302311883,7.72,6915.5,21346,21282,64,0.3007236162
26209,京都府,長岡京市,長岡京市,80107,79844,263,0.3293923150,19.17,4178.8,32476,31514,962,3.0526115377
26210,京都府,八幡市,八幡市,72748,74227,-1479,-1.9925364086,24.35,2987.6,29247,28795,452,1.5697169648
26211,京都府,京田辺市,京田辺市,70866,67910,2956,4.3528199087,42.92,1651.1,29707,27839,1868,6.7100111355
26212,京都府,京丹後市,京丹後市,55096,59038,-3942,-6.6770554558,501.46,109.9,20490,20690,-200,-0.9666505558
26213,京都府,南丹市,南丹市,33161,35214,-2053,-5.8300675868,616.40,53.8,12780,12721,59,0.4638000157
26214,京都府,木津川市,木津川市,72843,69761,3082,4.4179412566,85.13,855.7,26650,24393,2257,9.2526544500
26300,京都府,乙訓郡,乙訓郡,15190,15121,69,0.4563190265,5.97,2544.4,5993,5750,243,4.2260869565
26303,京都府,大山崎町,大山崎町,15190,15121,69,0.4563190265,5.97,2544.4,5993,5750,243,4.2260869565
26320,京都府,久世郡,久世郡,15819,15914,-95,-0.5969586528,13.86,1141.3,6197,5870,327,5.5706984668
26322,京都府,久御山町,久御山町,15819,15914,-95,-0.5969586528,13.86,1141.3,6197,5870,327,5.5706984668
26340,京都府,綴喜郡,綴喜郡,17239,18158,-919,-5.0611300804,76.21,226.2,6256,6207,49,0.7894312873
26343,京都府,井手町,井手町,7916,8447,-531,-6.2862554753,18.04,438.8,3051,3110,-59,-1.8971061093
26344,京都府,宇治田原町,宇治田原町,9323,9711,-388,-3.9954690557,58.16,160.3,3205,3097,108,3.4872457217
26360,京都府,相楽郡,相楽郡,44368,44816,-448,-0.9996429846,178.24,248.9,15848,15385,463,3.0094247644
26364,京都府,笠置町,笠置町,1369,1626,-257,-15.8056580566,23.52,58.2,573,631,-58,-9.1917591125
26365,京都府,和束町,和束町,3959,4482,-523,-11.6688978135,64.93,61.0,1445,1509,-64,-4.2412193506
26366,京都府,精華町,精華町,36388,35630,758,2.1274207129,25.68,1417.0,12761,12117,644,5.3148469093
26367,京都府,南山城村,南山城村,2652,3078,-426,-13.8401559454,64.11,41.4,1069,1128,-59,-5.2304964539
26400,京都府,船井郡,船井郡,14457,15732,-1275,-8.1045003814,303.09,47.7,5445,5660,-215,-3.7985865724
26407,京都府,京丹波町,京丹波町,14457,15732,-1275,-8.1045003814,303.09,47.7,5445,5660,-215,-3.7985865724
26460,京都府,与謝郡,与謝郡,23952,25864,-1912,-7.3925146922,170.33,140.6,9009,9286,-277,-2.9829851389
26463,京都府,伊根町,伊根町,2110,2410,-300,-12.4481327801,61.95,34.1,873,939,-66,-7.0287539936
26465,京都府,与謝野町,与謝野町,21842,23454,-1612,-6.8730280549,108.38,201.5,8136,8347,-211,-2.5278543189
27102,大阪府,大阪市都島区,大阪市 都島区,104735,102632,2103,2.0490685166,6.08,17226.2,51552,50075,1477,2.9495756365
27103,大阪府,大阪市福島区,大阪市 福島区,72463,67290,5173,7.6876207460,4.67,15516.7,37344,34379,2965,8.6244509730
27104,大阪府,大阪市此花区,大阪市 此花区,66640,65569,1071,1.6333938294,19.25,3461.8,30720,29495,1225,4.1532463129
27106,大阪府,大阪市西区,大阪市 西区,92418,83058,9360,11.2692335476,5.21,17738.6,52214,47073,5141,10.9213349478
27107,大阪府,大阪市港区,大阪市 港区,82063,84947,-2884,-3.3950580950,7.86,10440.6,40408,40713,-305,-0.7491464643
27108,大阪府,大阪市大正区,大阪市 大正区,65172,69510,-4338,-6.2408286577,9.43,6911.1,29181,30521,-1340,-4.3904197110
27109,大阪府,大阪市天王寺区,大阪市 天王寺区,75662,69775,5887,8.4371193121,4.84,15632.6,38013,34730,3283,9.4529225453
27111,大阪府,大阪市浪速区,大阪市 浪速区,69673,61745,7928,12.8399060653,4.39,15870.8,47163,42392,4771,11.2544819777
27113,大阪府,大阪市西淀川区,大阪市 西淀川区,95537,97504,-1967,-2.0173531342,14.22,6718.5,42981,43608,-627,-1.4378095762
27114,大阪府,大阪市東淀川区,大阪市 東淀川区,175587,176585,-998,-0.5651669168,13.27,13231.9,92519,91894,625,0.6801314558
27115,大阪府,大阪市東成区,大阪市 東成区,80592,80231,361,0.4499507672,4.54,17751.5,39658,38920,738,1.8961973279
27116,大阪府,大阪市生野区,大阪市 生野区,130194,134009,-3815,-2.8468237208,8.37,15554.8,63394,62808,586,0.9330021653
27117,大阪府,大阪市旭区,大阪市 旭区,91619,92455,-836,-0.9042236764,6.32,14496.7,43745,43842,-97,-0.2212490306
27118,大阪府,大阪市城東区,大阪市 城東区,164464,165832,-1368,-0.8249312557,8.38,19625.8,76565,76043,522,0.6864537170
27119,大阪府,大阪市阿倍野区,大阪市 阿倍野区,107750,106350,1400,1.3164080865,5.98,18018.4,50061,49318,743,1.5065493329
27120,大阪府,大阪市住吉区,大阪市 住吉区,154315,155572,-1257,-0.8079860129,9.40,16416.5,71725,73917,-2192,-2.9654883180
27121,大阪府,大阪市東住吉区,大阪市 東住吉区,126391,130724,-4333,-3.3146170558,9.75,12963.2,57949,60057,-2108,-3.5099988344
27122,大阪府,大阪市西成区,大阪市 西成区,111938,121972,-10034,-8.2264782081,7.37,15188.3,69401,74466,-5065,-6.8017618779
27123,大阪府,大阪市淀川区,大阪市 淀川区,176411,172078,4333,2.5180441428,12.64,13956.6,94470,91116,3354,3.6810219939
27124,大阪府,大阪市鶴見区,大阪市 鶴見区,111528,111182,346,0.3112014535,8.17,13650.9,46345,45264,1081,2.3882113821
27125,大阪府,大阪市住之江区,大阪市 住之江区,123035,127210,-4175,-3.2819746875,20.61,5969.7,56990,56593,397,0.7015001855
27126,大阪府,大阪市平野区,大阪市 平野区,196839,200005,-3166,-1.5829604260,15.28,12882.1,88842,86500,2342,2.7075144509
27127,大阪府,大阪市北区,大阪市 北区,123679,110392,13287,12.0361982752,10.34,11961.2,74007,65204,8803,13.5007054782
27128,大阪府,大阪市中央区,大阪市 中央区,93037,78687,14350,18.2368116716,8.87,10489.0,58955,49062,9893,20.1642819290
27141,大阪府,堺市堺区,堺市 堺区,148016,148748,-732,-0.4921074569,23.65,6258.6,69109,67426,1683,2.4960697654
27142,大阪府,堺市中区,堺市 中区,124518,123532,986,0.7981737525,17.88,6964.1,48576,47203,1373,2.9087134292
27143,大阪府,堺市東区,堺市 東区,85267,85444,-177,-0.2071532232,10.49,8128.4,34722,34404,318,0.9243111266
27144,大阪府,堺市西区,堺市 西区,135864,133622,2242,1.6778674170,28.61,4748.8,54597,53442,1155,2.1612215112
27145,大阪府,堺市南区,堺市 南区,147903,154779,-6876,-4.4424631248,40.39,3661.9,60380,61008,-628,-1.0293731970
27146,大阪府,堺市北区,堺市 北区,159110,156561,2549,1.6281193912,15.60,10199.4,68616,67116,1500,2.2349365278
27147,大阪府,堺市美原区,堺市 美原区,39213,39280,-67,-0.1705702648,13.20,2970.7,14318,13866,452,3.2597721044
27202,大阪府,岸和田市,岸和田市,194862,199234,-4372,-2.1944045695,72.55,2685.9,75232,75353,-121,-0.1605775483
27203,大阪府,豊中市,豊中市,394495,389341,5154,1.3237753024,36.39,10840.8,170274,166677,3597,2.1580661999
27204,大阪府,池田市,池田市,103041,104229,-1188,-1.1397979449,22.14,4654.1,45638,45661,-23,-0.0503712139
27205,大阪府,吹田市,吹田市,374526,355798,18728,5.2636608413,36.09,10377.6,169405,154702,14703,9.5040788096
27206,大阪府,泉大津市,泉大津市,75880,77548,-1668,-2.1509258782,14.31,5302.6,31064,30962,102,0.3294360829
27207,大阪府,高槻市,高槻市,351831,357359,-5528,-1.5469038138,105.29,3341.5,147538,145426,2112,1.4522850109
27208,大阪府,貝塚市,貝塚市,88703,90492,-1789,-1.9769703399,43.93,2019.2,33301,32986,315,0.9549505851
27209,大阪府,守口市,守口市,143068,146697,-3629,-2.4738065536,12.71,11256.3,65638,65129,509,0.7815258948
27210,大阪府,枚方市,枚方市,403893,407978,-4085,-1.0012794808,65.12,6202.3,167377,163983,3394,2.0697267400
27211,大阪府,茨木市,茨木市,280170,274822,5348,1.9459868569,76.49,3662.8,116704,112282,4422,3.9382982134
27212,大阪府,八尾市,八尾市,268562,271460,-2898,-1.0675605982,41.72,6437.2,109945,108704,1241,1.1416323226
27213,大阪府,泉佐野市,泉佐野市,101025,100801,224,0.2222200177,56.51,1787.7,41499,39084,2415,6.1789990789
27214,大阪府,富田林市,富田林市,114076,119576,-5500,-4.5995852010,39.72,2872.0,45638,45600,38,0.0833333333
27215,大阪府,寝屋川市,寝屋川市,237814,238204,-390,-0.1637252103,24.70,9628.1,101415,99178,2237,2.2555405433
27216,大阪府,河内長野市,河内長野市,107114,112490,-5376,-4.7790914748,109.63,977.1,42063,41339,724,1.7513727957
27217,大阪府,松原市,松原市,120697,124594,-3897,-3.1277589611,16.66,7244.7,49610,49218,392,0.7964565809
27218,大阪府,大東市,大東市,122982,127534,-4552,-3.5692442800,18.27,6731.4,52022,52381,-359,-0.6853630133
27219,大阪府,和泉市,和泉市,186128,184988,1140,0.6162561896,84.98,2190.3,70855,68342,2513,3.6770946124
27220,大阪府,箕面市,箕面市,133418,129895,3523,2.7121906155,47.90,2785.3,56860,53560,3300,6.1613144137
27221,大阪府,柏原市,柏原市,71276,74773,-3497,-4.6768218475,25.33,2813.9,28999,29685,-686,-2.3109314469
27222,大阪府,羽曳野市,羽曳野市,112695,117681,-4986,-4.2368776608,26.45,4260.7,44076,44693,-617,-1.3805293894
27223,大阪府,門真市,門真市,122808,130282,-7474,-5.7367863558,12.30,9984.4,55458,57880,-2422,-4.1845196959
27224,大阪府,摂津市,摂津市,85054,83720,1334,1.5934065934,14.87,5719.8,36801,34987,1814,5.1847829194
27225,大阪府,高石市,高石市,56485,59572,-3087,-5.1819646814,11.29,5003.1,22480,23012,-532,-2.3118373023
27226,大阪府,藤井寺市,藤井寺市,65454,66165,-711,-1.0745862616,8.89,7362.7,27137,26754,383,1.4315616356
27227,大阪府,東大阪市,東大阪市,502605,509533,-6928,-1.3596764096,61.78,8135.4,223040,217762,5278,2.4237470266
27228,大阪府,泉南市,泉南市,62500,64403,-1903,-2.9548312967,48.98,1276.0,22785,22604,181,0.8007432313
27229,大阪府,四條畷市,四條畷市,56092,57554,-1462,-2.5402230948,18.69,3001.2,22076,21726,350,1.6109730277
27230,大阪府,交野市,交野市,76459,77686,-1227,-1.5794351621,25.55,2992.5,28920,28488,432,1.5164279697
27231,大阪府,大阪狭山市,大阪狭山市,57803,58227,-424,-0.7281845192,11.92,4849.2,22878,22473,405,1.8021625951
27232,大阪府,阪南市,阪南市,54137,56646,-2509,-4.4292624369,36.17,1496.7,20607,20500,107,0.5219512195
27300,大阪府,三島郡,三島郡,29986,28935,1051,3.6322792466,16.81,1783.8,12008,11248,760,6.7567567568
27301,大阪府,島本町,島本町,29986,28935,1051,3.6322792466,16.81,1783.8,12008,11248,760,6.7567567568
27320,大阪府,豊能郡,豊能郡,30199,33639,-3440,-10.2262255121,133.09,226.9,11366,11724,-358,-3.0535653361
27321,大阪府,豊能町,豊能町,19941,21989,-2048,-9.3137477830,34.34,580.7,7694,7871,-177,-2.2487612756
27322,大阪府,能勢町,能勢町,10258,11650,-1392,-11.9484978541,98.75,103.9,3672,3853,-181,-4.6976382040
27340,大阪府,泉北郡,泉北郡,17297,18149,-852,-4.6944735247,3.97,4356.9,6662,6744,-82,-1.2158956109
27341,大阪府,忠岡町,忠岡町,17297,18149,-852,-4.6944735247,3.97,4356.9,6662,6744,-82,-1.2158956109
27360,大阪府,泉南郡,泉南郡,68832,70685,-1853,-2.6214897079,72.03,955.6,26843,25689,1154,4.4921951030
27361,大阪府,熊取町,熊取町,44466,45096,-630,-1.3970196913,17.24,2579.2,16688,15775,913,5.7876386688
27362,大阪府,田尻町,田尻町,8419,8085,334,4.1311069882,5.62,1498.0,3761,3255,506,15.5453149002
27366,大阪府,岬町,岬町,15947,17504,-1557,-8.8951096892,49.18,324.3,6394,6659,-265,-3.9795765130
27380,大阪府,南河内郡,南河内郡,35308,37275,-1967,-5.2769953052,76.72,460.2,13189,13395,-206,-1.5378872714
27381,大阪府,太子町,太子町,13739,14220,-481,-3.3825597750,14.17,969.6,5060,4881,179,3.6672812948
27382,大阪府,河南町,河南町,16191,17040,-849,-4.9823943662,25.26,641.0,6105,6426,-321,-4.9953314659
27383,大阪府,千早赤阪村,千早赤阪村,5378,6015,-637,-10.5901911887,37.30,144.2,2024,2088,-64,-3.0651340996
28101,兵庫県,神戸市東灘区,神戸市 東灘区,213727,210408,3319,1.5774115053,34.02,6282.4,97147,94039,3108,3.3050117504
28102,兵庫県,神戸市灘区,神戸市 灘区,136130,133451,2679,2.0074784003,32.66,4168.1,67356,65178,2178,3.3416183375
28105,兵庫県,神戸市兵庫区,神戸市 兵庫区,106983,108304,-1321,-1.2197148766,14.68,7287.7,57810,56954,856,1.5029673069
28106,兵庫県,神戸市長田区,神戸市 長田区,97952,101624,-3672,-3.6133196883,11.36,8622.5,48722,48224,498,1.0326808228
28107,兵庫県,神戸市須磨区,神戸市 須磨区,162533,167475,-4942,-2.9508881923,28.93,5618.1,73295,71657,1638,2.2858897247
28108,兵庫県,神戸市垂水区,神戸市 垂水区,219554,220411,-857,-0.3888190698,28.11,7810.5,95512,94016,1496,1.5912185160
28109,兵庫県,神戸市北区,神戸市 北区,219868,226836,-6968,-3.0718228147,240.29,915.0,87233,86350,883,1.0225825130
28110,兵庫県,神戸市中央区,神戸市 中央区,135218,126393,8825,6.9821904694,28.97,4667.5,80917,73814,7103,9.6228357764
28111,兵庫県,神戸市西区,神戸市 西区,245895,249298,-3403,-1.3650330127,138.01,1781.7,97069,93951,3118,3.3187512640
28201,兵庫県,姫路市,姫路市,535807,536270,-463,-0.0863371063,534.33,1002.8,212563,205587,6976,3.3932106602
28202,兵庫県,尼崎市,尼崎市,452571,453748,-1177,-0.2593950827,50.72,8922.9,210253,209343,910,0.4346933024
28203,兵庫県,明石市,明石市,293509,290959,2550,0.8764121405,49.42,5939.1,121866,116948,4918,4.2052878202
28204,兵庫県,西宮市,西宮市,488147,482640,5507,1.1410160782,99.96,4883.4,210890,202648,8242,4.0671509218
28205,兵庫県,洲本市,洲本市,44271,47254,-2983,-6.3126931053,182.38,242.7,18090,18447,-357,-1.9352740283
28206,兵庫県,芦屋市,芦屋市,95440,93238,2202,2.3616980201,18.47,5167.3,41959,39753,2206,5.5492667220
28207,兵庫県,伊丹市,伊丹市,197040,196127,913,0.4655146920,25.00,7881.6,78904,77263,1641,2.1239144222
28208,兵庫県,相生市,相生市,30142,31158,-1016,-3.2607997946,90.40,333.4,12135,12141,-6,-0.0494193230
28209,兵庫県,豊岡市,豊岡市,82269,85592,-3323,-3.8823721843,697.55,117.9,30152,29741,411,1.3819306681
28210,兵庫県,加古川市,加古川市,267434,266937,497,0.1861862537,138.48,1931.2,103457,99645,3812,3.8255808119
28212,兵庫県,赤穂市,赤穂市,48591,50523,-1932,-3.8240009501,126.86,383.0,18714,18826,-112,-0.5949219165
28213,兵庫県,西脇市,西脇市,40890,42802,-1912,-4.4670809775,132.44,308.7,15045,14989,56,0.3736073120
28214,兵庫県,宝市,宝市,224977,225700,-723,-0.3203367302,101.80,2210.0,94206,91737,2469,2.6913895157
28215,兵庫県,三木市,三木市,77310,81009,-3699,-4.5661593156,176.51,438.0,28584,28506,78,0.2736266049
28216,兵庫県,高砂市,高砂市,91065,93901,-2836,-3.0202021278,34.45,2643.4,36330,35737,593,1.6593446568
28217,兵庫県,川西市,川西市,156481,156423,58,0.0370789462,53.44,2928.2,62653,60584,2069,3.4150930939
28218,兵庫県,小野市,小野市,48605,49680,-1075,-2.1638486312,92.94,523.0,16856,16470,386,2.3436551305
28219,兵庫県,三田市,三田市,112732,114216,-1484,-1.2992925685,210.32,536.0,41044,40068,976,2.4358590396
28220,兵庫県,加西市,加西市,44352,47993,-3641,-7.5865230346,150.98,293.8,15356,15188,168,1.1061364235
28221,兵庫県,篠山市,篠山市,41506,43263,-1757,-4.0612070360,377.59,109.9,15565,15342,223,1.4535262678
28222,兵庫県,養父市,養父市,24293,26501,-2208,-8.3317610656,422.91,57.4,8713,9062,-349,-3.8512469653
28223,兵庫県,丹波市,丹波市,64689,67757,-3068,-4.5279454521,493.21,131.2,22563,22461,102,0.4541204755
28224,兵庫県,南あわじ市,南あわじ市,46948,49834,-2886,-5.7912268732,229.01,205.0,16964,16981,-17,-0.1001118898
28225,兵庫県,朝来市,朝来市,30855,32814,-1959,-5.9700127994,403.06,76.6,11497,11655,-158,-1.3556413556
28226,兵庫県,淡路市,淡路市,43925,46459,-2534,-5.4542715082,184.35,238.3,17508,17436,72,0.4129387474
28227,兵庫県,宍粟市,宍粟市,37792,40938,-3146,-7.6847916361,658.54,57.4,12736,13174,-438,-3.3247305298
28228,兵庫県,加東市,加東市,40332,40181,151,0.3757995072,157.55,256.0,15104,14133,971,6.8704450577
28229,兵庫県,たつの市,たつの市,77443,80518,-3075,-3.8190218336,210.87,367.3,27286,26803,483,1.8020370854
28300,兵庫県,川辺郡,川辺郡,30851,31739,-888,-2.7978197171,90.33,341.5,10779,10547,232,2.1996776335
28301,兵庫県,猪名川町,猪名川町,30851,31739,-888,-2.7978197171,90.33,341.5,10779,10547,232,2.1996776335
28360,兵庫県,多可郡,多可郡,21222,23104,-1882,-8.1457756233,185.19,114.6,6648,6709,-61,-0.9092264123
28365,兵庫県,多可町,多可町,21222,23104,-1882,-8.1457756233,185.19,114.6,6648,6709,-61,-0.9092264123
28380,兵庫県,加古郡,加古郡,64788,64209,579,0.9017427463,44.05,1470.8,24239,22807,1432,6.2787740606
28381,兵庫県,稲美町,稲美町,31033,31026,7,0.0225617224,34.92,888.7,11018,10226,792,7.7449638177
28382,兵庫県,播磨町,播磨町,33755,33183,572,1.7237742217,9.13,3697.2,13221,12581,640,5.0870360067
28440,兵庫県,神崎郡,神崎郡,43518,45407,-1889,-4.1601515185,330.70,131.6,15037,14802,235,1.5876232941
28442,兵庫県,市川町,市川町,12311,13288,-977,-7.3524984949,82.67,148.9,4335,4350,-15,-0.3448275862
28443,兵庫県,福崎町,福崎町,19745,19830,-85,-0.4286434695,45.79,431.2,6904,6639,265,3.9915649947
28446,兵庫県,神河町,神河町,11462,12289,-827,-6.7295955733,202.23,56.7,3798,3813,-15,-0.3933910307
28460,兵庫県,揖保郡,揖保郡,33699,33438,261,0.7805490759,22.61,1490.4,12087,11640,447,3.8402061856
28464,兵庫県,太子町,太子町,33699,33438,261,0.7805490759,22.61,1490.4,12087,11640,447,3.8402061856
28480,兵庫県,赤穂郡,赤穂郡,15233,16636,-1403,-8.4335176725,150.26,101.4,5714,5870,-156,-2.6575809199
28481,兵庫県,上郡町,上郡町,15233,16636,-1403,-8.4335176725,150.26,101.4,5714,5870,-156,-2.6575809199
28500,兵庫県,佐用郡,佐用郡,17508,19265,-1757,-9.1201661043,307.44,56.9,6108,6301,-193,-3.0630058721
28501,兵庫県,佐用町,佐用町,17508,19265,-1757,-9.1201661043,307.44,56.9,6108,6301,-193,-3.0630058721
28580,兵庫県,美方郡,美方郡,32894,35700,-2806,-7.8599439776,609.78,53.9,11540,11791,-251,-2.1287422610
28585,兵庫県,香美町,香美町,18076,19696,-1620,-8.2250203087,368.77,49.0,6224,6449,-225,-3.4889130098
28586,兵庫県,新温泉町,新温泉町,14818,16004,-1186,-7.4106473382,241.01,61.5,5316,5342,-26,-0.4867090977
29201,奈良県,奈良市,奈良市,360439,366591,-6152,-1.6781644939,276.94,1301.5,149274,147421,1853,1.2569443973
29202,奈良県,大和高田市,大和高田市,64856,68451,-3595,-5.2519320390,16.48,3935.4,25604,25815,-211,-0.8173542514
29203,奈良県,大和郡山市,大和郡山市,87180,89023,-1843,-2.0702515080,42.69,2042.2,34149,33235,914,2.7501128329
29204,奈良県,天理市,天理市,67437,69178,-1741,-2.5166960594,86.42,780.3,25725,25396,329,1.2954796031
29205,奈良県,橿原市,橿原市,124126,125605,-1479,-1.1775008957,39.56,3137.7,49863,48740,1123,2.3040623718
29206,奈良県,桜井市,桜井市,57253,60146,-2893,-4.8099624248,98.91,578.8,21648,21417,231,1.0785824345
29207,奈良県,五條市,五條市,31012,34460,-3448,-10.0058038305,292.02,106.2,11171,11738,-567,-4.8304651559
29208,奈良県,御所市,御所市,26888,30287,-3399,-11.2226367749,60.58,443.8,10416,10603,-187,-1.7636517967
29209,奈良県,生駒市,生駒市,118297,118113,184,0.1557830213,53.15,2225.7,45597,44484,1113,2.5020231994
29210,奈良県,香芝市,香芝市,77637,75227,2410,3.2036369920,24.26,3200.2,27777,26131,1646,6.2990318013
29211,奈良県,葛城市,葛城市,36655,35859,796,2.2198053487,33.72,1087.0,12546,11891,655,5.5083676730
29212,奈良県,宇陀市,宇陀市,31117,34227,-3110,-9.0863937827,247.50,125.7,11145,11527,-382,-3.3139585321
29320,奈良県,山辺郡,山辺郡,3676,4107,-431,-10.4942780618,66.52,55.3,1144,1196,-52,-4.3478260870
29322,奈良県,山添村,山添村,3676,4107,-431,-10.4942780618,66.52,55.3,1144,1196,-52,-4.3478260870
29340,奈良県,生駒郡,生駒郡,77196,78830,-1634,-2.0728149182,51.27,1505.7,29455,29186,269,0.9216747756
29342,奈良県,平群町,平群町,18897,19727,-830,-4.2074314391,23.90,790.7,7105,7090,15,0.2115655853
29343,奈良県,三郷町,三郷町,23541,23440,101,0.4308873720,8.79,2678.2,9148,8978,170,1.8935174872
29344,奈良県,斑鳩町,斑鳩町,27314,27734,-420,-1.5143866734,14.27,1914.1,10330,10184,146,1.4336213668
29345,奈良県,安堵町,安堵町,7444,7929,-485,-6.1167864800,4.31,1727.1,2872,2934,-62,-2.1131561009
29360,奈良県,磯城郡,磯城郡,47047,48214,-1167,-2.4204587879,31.09,1513.3,17329,16743,586,3.4999701368
29361,奈良県,川西町,川西町,8500,8653,-153,-1.7681728880,5.93,1433.4,3233,3152,81,2.5697969543
29362,奈良県,三宅町,三宅町,6838,7440,-602,-8.0913978495,4.06,1684.2,2628,2637,-9,-0.3412969283
29363,奈良県,田原本町,田原本町,31709,32121,-412,-1.2826499798,21.09,1503.5,11468,10954,514,4.6923498265
29380,奈良県,宇陀郡,宇陀郡,3307,3997,-690,-17.2629472104,127.34,26.0,1392,1488,-96,-6.4516129032
29385,奈良県,曽爾村,曽爾村,1549,1895,-346,-18.2585751979,47.76,32.4,644,675,-31,-4.5925925926
29386,奈良県,御杖村,御杖村,1758,2102,-344,-16.3653663178,79.58,22.1,748,813,-65,-7.9950799508
29400,奈良県,高市郡,高市郡,12717,13513,-796,-5.8906238437,49.89,254.9,4174,4234,-60,-1.4170996693
29401,奈良県,高取町,高取町,7191,7657,-466,-6.0859344391,25.79,278.8,2395,2435,-40,-1.6427104723
29402,奈良県,明日香村,明日香村,5526,5856,-330,-5.6352459016,24.10,229.3,1779,1799,-20,-1.1117287382
29420,奈良県,北葛城郡,北葛城郡,96606,97511,-905,-0.9281004194,37.68,2563.9,35178,34274,904,2.6375678357
29424,奈良県,上牧町,上牧町,22093,23728,-1635,-6.8905933918,6.14,3598.2,8156,8368,-212,-2.5334608031
29425,奈良県,王寺町,王寺町,23050,22182,868,3.9130826797,7.01,3288.2,9292,8718,574,6.5840789172
29426,奈良県,広陵町,広陵町,33523,33070,453,1.3698215906,16.30,2056.6,11017,10525,492,4.6745843230
29427,奈良県,河合町,河合町,17940,18531,-591,-3.1892504452,8.23,2179.8,6713,6663,50,0.7504127270
29440,奈良県,吉野郡,吉野郡,41562,47389,-5827,-12.2961024710,2054.91,20.2,16738,18004,-1266,-7.0317707176
29441,奈良県,吉野町,吉野町,7398,8642,-1244,-14.3948160148,95.65,77.3,2939,3172,-233,-7.3455233291
29442,奈良県,大淀町,大淀町,18071,19176,-1105,-5.7624113475,38.10,474.3,6524,6609,-85,-1.2861249811
29443,奈良県,下市町,下市町,5662,7020,-1358,-19.3447293447,61.99,91.3,2237,2434,-197,-8.0936729663
29444,奈良県,黒滝村,黒滝村,655,840,-185,-22.0238095238,47.70,13.7,311,357,-46,-12.8851540616
29446,奈良県,天川村,天川村,1353,1572,-219,-13.9312977099,175.66,7.7,624,711,-87,-12.2362869198
29447,奈良県,野迫川村,野迫川村,449,524,-75,-14.3129770992,154.90,2.9,227,249,-22,-8.8353413655
29449,奈良県,十津川村,十津川村,3508,4107,-599,-14.5848551254,672.38,5.2,1577,1831,-254,-13.8722009831
29450,奈良県,下北山村,下北山村,892,1039,-147,-14.1482194418,133.39,6.7,517,559,-42,-7.5134168157
29451,奈良県,上北山村,上北山村,510,683,-173,-25.3294289898,274.22,1.9,270,361,-91,-25.2077562327
29452,奈良県,川上村,川上村,1320,1643,-323,-19.6591600730,269.26,4.9,683,786,-103,-13.1043256997
29453,奈良県,東吉野村,東吉野村,1744,2143,-399,-18.6187587494,131.65,13.2,829,935,-106,-11.3368983957
30201,和歌山県,和歌山市,和歌山市,364285,370364,-6079,-1.6413582314,208.84,1744.3,152866,152569,297,0.1946660200
30202,和歌山県,海南市,海南市,51879,54783,-2904,-5.3009145173,101.06,513.3,20680,20750,-70,-0.3373493976
30203,和歌山県,橋本市,橋本市,63609,66361,-2752,-4.1470140595,130.55,487.2,23626,23468,158,0.6732572013
30204,和歌山県,有田市,有田市,28479,30592,-2113,-6.9070345188,36.89,772.0,10572,10735,-163,-1.5183977643
30205,和歌山県,御坊市,御坊市,24803,26111,-1308,-5.0093830187,43.91,564.9,9907,9993,-86,-0.8606024217
30206,和歌山県,田辺市,田辺市,74777,79119,-4342,-5.4879358940,1026.91,72.8,32200,32693,-493,-1.5079680666
30207,和歌山県,新宮市,新宮市,29334,31498,-2164,-6.8702774779,255.23,114.9,13608,14063,-455,-3.2354405177
30208,和歌山県,紀の川市,紀の川市,62650,65840,-3190,-4.8450789793,228.21,274.5,23454,23226,228,0.9816584862
30209,和歌山県,岩出市,岩出市,53476,52882,594,1.1232555501,38.51,1388.6,20667,19545,1122,5.7405986186
30300,和歌山県,海草郡,海草郡,9211,10391,-1180,-11.3559811375,128.34,71.8,3763,3971,-208,-5.2379753211
30304,和歌山県,紀美野町,紀美野町,9211,10391,-1180,-11.3559811375,128.34,71.8,3763,3971,-208,-5.2379753211
30340,和歌山県,伊都郡,伊都郡,24736,27168,-2432,-8.9517078916,332.88,74.3,9428,9992,-564,-5.6445156125
30341,和歌山県,かつらぎ町,かつらぎ町,17009,18230,-1221,-6.6977509600,151.69,112.1,6319,6463,-144,-2.2280674609
30343,和歌山県,九度山町,九度山町,4384,4963,-579,-11.6663308483,44.15,99.3,1647,1741,-94,-5.3991958644
30344,和歌山県,高野町,高野町,3343,3975,-632,-15.8993710692,137.03,24.4,1462,1788,-326,-18.2326621924
30360,和歌山県,有田郡,有田郡,45814,48086,-2272,-4.7248679449,437.97,104.6,16688,16692,-4,-0.0239635754
30361,和歌山県,湯浅町,湯浅町,12205,13210,-1005,-7.6078728236,20.79,587.1,4760,4971,-211,-4.2446187890
30362,和歌山県,広川町,広川町,7230,7714,-484,-6.2743064558,65.33,110.7,2506,2496,10,0.4006410256
30366,和歌山県,有田川町,有田川町,26379,27162,-783,-2.8827037773,351.84,75.0,9422,9225,197,2.1355013550
30380,和歌山県,日高郡,日高郡,51550,54602,-3052,-5.5895388447,655.38,78.7,18944,19313,-369,-1.9106301455
30381,和歌山県,美浜町,美浜町,7482,8077,-595,-7.3665965086,12.77,585.9,2962,3086,-124,-4.0181464679
30382,和歌山県,日高町,日高町,7641,7432,209,2.8121636168,46.40,164.7,2783,2648,135,5.0981873112
30383,和歌山県,由良町,由良町,5839,6508,-669,-10.2796558082,30.73,190.0,2213,2419,-206,-8.5159156676
30390,和歌山県,印南町,印南町,8067,8606,-539,-6.2630722752,113.62,71.0,2919,3015,-96,-3.1840796020
30391,和歌山県,みなべ町,みなべ町,12741,13470,-729,-5.4120267261,120.28,105.9,4421,4395,26,0.5915813424
30392,和歌山県,日高川町,日高川町,9780,10509,-729,-6.9369112190,331.59,29.5,3646,3750,-104,-2.7733333333
30400,和歌山県,西牟婁郡,西牟婁郡,40650,42233,-1583,-3.7482537352,432.80,93.9,17460,17340,120,0.6920415225
30401,和歌山県,白浜町,白浜町,21534,22696,-1162,-5.1198449066,200.96,107.2,9508,9616,-108,-1.1231281198
30404,和歌山県,上富田町,上富田町,14986,14807,179,1.2088876883,57.37,261.2,6025,5610,415,7.3975044563
30406,和歌山県,すさみ町,すさみ町,4130,4730,-600,-12.6849894292,174.46,23.7,1927,2114,-187,-8.8457899716
30420,和歌山県,東牟婁郡,東牟婁郡,38597,42168,-3571,-8.4685069247,667.21,57.8,18061,19203,-1142,-5.9469874499
30421,和歌山県,那智勝浦町,那智勝浦町,15681,17080,-1399,-8.1908665105,183.31,85.5,7292,7723,-431,-5.5807328758
30422,和歌山県,太地町,太地町,3086,3250,-164,-5.0461538462,5.81,531.2,1382,1417,-35,-2.4700070572
30424,和歌山県,古座川町,古座川町,2825,3103,-278,-8.9590718659,294.23,9.6,1382,1484,-102,-6.8733153639
30427,和歌山県,北山村,北山村,446,486,-40,-8.2304526749,48.20,9.3,239,256,-17,-6.6406250000
30428,和歌山県,串本町,串本町,16559,18249,-1690,-9.2607814127,135.67,122.1,7766,8323,-557,-6.6922984501
31201,鳥取県,鳥取市,鳥取市,193766,197449,-3683,-1.8652917969,765.31,253.2,75384,73288,2096,2.8599497871
31202,鳥取県,米子市,米子市,149382,148271,1111,0.7493036400,132.42,1128.1,59570,57610,1960,3.4021871203
31203,鳥取県,倉吉市,倉吉市,49070,50720,-1650,-3.2531545741,272.06,180.4,18385,18266,119,0.6514836308
31204,鳥取県,境港市,境港市,34186,35259,-1073,-3.0431946453,29.02,1178.0,13009,12870,139,1.0800310800
31300,鳥取県,岩美郡,岩美郡,11488,12362,-874,-7.0700533894,122.32,93.9,3977,3982,-5,-0.1255650427
31302,鳥取県,岩美町,岩美町,11488,12362,-874,-7.0700533894,122.32,93.9,3977,3982,-5,-0.1255650427
31320,鳥取県,八頭郡,八頭郡,27415,30018,-2603,-8.6714637884,630.58,43.5,9104,9428,-324,-3.4365719134
31325,鳥取県,若桜町,若桜町,3272,3873,-601,-15.5176865479,199.18,16.4,1261,1405,-144,-10.2491103203
31328,鳥取県,智頭町,智頭町,7153,7718,-565,-7.3205493651,224.70,31.8,2487,2569,-82,-3.1919034644
31329,鳥取県,八頭町,八頭町,16990,18427,-1437,-7.7983393933,206.71,82.2,5356,5454,-98,-1.7968463513
31360,鳥取県,東伯郡,東伯郡,55297,58017,-2720,-4.6882810211,508.37,108.8,18357,18447,-90,-0.4878842088
31364,鳥取県,三朝町,三朝町,6482,7015,-533,-7.5980042766,233.52,27.8,2291,2385,-94,-3.9412997904
31370,鳥取県,湯梨浜町,湯梨浜町,16557,17029,-472,-2.7717423219,77.94,212.4,5482,5418,64,1.1812476929
31371,鳥取県,琴浦町,琴浦町,17423,18531,-1108,-5.9791700394,139.97,124.5,5773,5834,-61,-1.0455947892
31372,鳥取県,北栄町,北栄町,14835,15442,-607,-3.9308379744,56.94,260.5,4811,4810,1,0.0207900208
31380,鳥取県,西伯郡,西伯郡,42005,43987,-1982,-4.5058767363,447.51,93.9,13540,13529,11,0.0813068224
31384,鳥取県,日吉津村,日吉津村,3449,3339,110,3.2943995208,4.20,821.2,1147,1070,77,7.1962616822
31386,鳥取県,大山町,大山町,16480,17491,-1011,-5.7801154880,189.83,86.8,5297,5338,-41,-0.7680779318
31389,鳥取県,南部町,南部町,10956,11536,-580,-5.0277392510,114.03,96.1,3496,3511,-15,-0.4272287098
31390,鳥取県,伯耆町,伯耆町,11120,11621,-501,-4.3111608295,139.44,79.7,3600,3610,-10,-0.2770083102
31400,鳥取県,日野郡,日野郡,11039,12584,-1545,-12.2774952320,599.46,18.4,4216,4544,-328,-7.2183098592
31401,鳥取県,日南町,日南町,4764,5460,-696,-12.7472527473,340.96,14.0,1933,2099,-166,-7.9085278704
31402,鳥取県,日野町,日野町,3273,3745,-472,-12.6034712951,133.98,24.4,1276,1371,-95,-6.9292487236
31403,鳥取県,江府町,江府町,3002,3379,-377,-11.1571470849,124.52,24.1,1007,1074,-67,-6.2383612663
32201,島根県,松江市,松江市,206407,208613,-2206,-1.0574604651,572.99,360.2,82993,81166,1827,2.2509425129
32202,島根県,浜田市,浜田市,58120,61713,-3593,-5.8221120347,690.66,84.2,24508,24972,-464,-1.8580810508
32203,島根県,出雲市,出雲市,171576,171485,91,0.0530658658,624.36,274.8,59719,55952,3767,6.7325564770
32204,島根県,益田市,益田市,47701,50015,-2314,-4.6266120164,733.19,65.1,19033,19243,-210,-1.0913059294
32205,島根県,大田市,大田市,35167,37996,-2829,-7.4455205811,435.71,80.7,13634,14312,-678,-4.7372833985
32206,島根県,安来市,安来市,39553,41836,-2283,-5.4570226599,420.93,94.0,12796,12820,-24,-0.1872074883
32207,島根県,江津市,江津市,24450,25697,-1247,-4.8527065416,268.24,91.1,10058,10320,-262,-2.5387596899
32209,島根県,雲南市,雲南市,39059,41917,-2858,-6.8182360379,553.18,70.6,12518,12905,-387,-2.9988376598
32340,島根県,仁多郡,仁多郡,13071,14456,-1385,-9.5807969009,368.01,35.5,4471,4713,-242,-5.1347337153
32343,島根県,奥出雲町,奥出雲町,13071,14456,-1385,-9.5807969009,368.01,35.5,4471,4713,-242,-5.1347337153
32380,島根県,飯石郡,飯石郡,5028,5534,-506,-9.1434766896,242.88,20.7,1842,1944,-102,-5.2469135802
32386,島根県,飯南町,飯南町,5028,5534,-506,-9.1434766896,242.88,20.7,1842,1944,-102,-5.2469135802
32440,島根県,邑智郡,邑智郡,19439,21210,-1771,-8.3498349835,808.63,24.0,7682,8333,-651,-7.8123124925
32441,島根県,川本町,川本町,3440,3900,-460,-11.7948717949,106.43,32.3,1454,1666,-212,-12.7250900360
32448,島根県,美郷町,美郷町,4899,5351,-452,-8.4470192487,282.92,17.3,2006,2157,-151,-7.0004636069
32449,島根県,邑南町,邑南町,11100,11959,-859,-7.1828748223,419.29,26.5,4222,4510,-288,-6.3858093126
32500,島根県,鹿足郡,鹿足郡,14029,15237,-1208,-7.9280698300,643.54,21.8,6092,6216,-124,-1.9948519949
32501,島根県,津和野町,津和野町,7658,8427,-769,-9.1254301649,307.03,24.9,3299,3411,-112,-3.2834945764
32505,島根県,吉賀町,吉賀町,6371,6810,-439,-6.4464023495,336.50,18.9,2793,2805,-12,-0.4278074866
32520,島根県,隠岐郡,隠岐郡,20588,21688,-1100,-5.0719291774,345.92,59.6,9135,9323,-188,-2.0165182881
32525,島根県,海士町,海士町,2354,2374,-20,-0.8424599832,33.43,70.4,1054,1052,2,0.1901140684
32526,島根県,西ノ島町,西ノ島町,3028,3136,-108,-3.4438775510,55.95,54.1,1504,1477,27,1.8280297901
32527,島根県,知夫村,知夫村,615,657,-42,-6.3926940639,13.70,44.9,331,326,5,1.5337423313
32528,島根県,隠岐の島町,隠岐の島町,14591,15521,-930,-5.9918819664,242.83,60.1,6246,6468,-222,-3.4322820037
33101,岡山県,岡山市北区,岡山市 北区,309496,302685,6811,2.2501940962,450.70,686.7,145974,139204,6770,4.8633659952
33102,岡山県,岡山市中区,岡山市 中区,146265,142237,4028,2.8318932486,51.25,2854.0,61501,58961,2540,4.3079323621
33103,岡山県,岡山市東区,岡山市 東区,95604,96948,-1344,-1.3863101869,160.53,595.6,36137,35199,938,2.6648484332
33104,岡山県,岡山市南区,岡山市 南区,168219,167714,505,0.3011078383,127.48,1319.6,65489,63426,2063,3.2526093400
33202,岡山県,倉敷市,倉敷市,477435,475513,1922,0.4041950483,355.63,1342.5,189736,183303,6433,3.5094897519
33203,岡山県,津山市,津山市,103714,106788,-3074,-2.8786005918,506.33,204.8,40304,39876,428,1.0733273147
33204,岡山県,玉野市,玉野市,60782,64588,-3806,-5.8927354927,103.58,586.8,24736,25449,-713,-2.8016817950
33205,岡山県,笠岡市,笠岡市,50593,54225,-3632,-6.6980175196,136.39,370.9,19155,19676,-521,-2.6478959138
33207,岡山県,井原市,井原市,41419,43927,-2508,-5.7094725340,243.54,170.1,14898,15108,-210,-1.3899920572
33208,岡山県,総社市,総社市,66888,66201,687,1.0377486745,211.90,315.7,24847,23459,1388,5.9167057419
33209,岡山県,高梁市,高梁市,32091,34963,-2872,-8.2143980780,546.99,58.7,13416,14121,-705,-4.9925642660
33210,岡山県,新見市,新見市,30677,33870,-3193,-9.4272217301,793.29,38.7,11667,12208,-541,-4.4315203145
33211,岡山県,備前市,備前市,35207,37839,-2632,-6.9557863580,258.29,136.3,13826,14136,-310,-2.1929824561
33212,岡山県,瀬戸内市,瀬戸内市,36983,37852,-869,-2.2957835781,125.45,294.8,13646,13343,303,2.2708536311
33213,岡山県,赤磐市,赤磐市,43218,43458,-240,-0.5522573519,209.36,206.4,15704,15274,430,2.8152415870
33214,岡山県,真庭市,真庭市,46137,48964,-2827,-5.7736296054,828.53,55.7,16079,16458,-379,-2.3028314498
33215,岡山県,美作市,美作市,27956,30498,-2542,-8.3349727851,429.29,65.1,10885,11205,-320,-2.8558679161
33216,岡山県,浅口市,浅口市,34256,36114,-1858,-5.1448191837,66.46,515.4,12452,12280,172,1.4006514658
33340,岡山県,和気郡,和気郡,14410,15362,-952,-6.1971097513,144.21,99.9,5211,5394,-183,-3.3926585095
33346,岡山県,和気町,和気町,14410,15362,-952,-6.1971097513,144.21,99.9,5211,5394,-183,-3.3926585095
33420,岡山県,都窪郡,都窪郡,12159,12214,-55,-0.4503029311,7.62,1595.7,4347,4200,147,3.5000000000
33423,岡山県,早島町,早島町,12159,12214,-55,-0.4503029311,7.62,1595.7,4347,4200,147,3.5000000000
33440,岡山県,浅口郡,浅口郡,10937,10916,21,0.1923781605,12.23,894.3,4024,3795,229,6.0342555995
33445,岡山県,里庄町,里庄町,10937,10916,21,0.1923781605,12.23,894.3,4024,3795,229,6.0342555995
33460,岡山県,小田郡,小田郡,14213,15092,-879,-5.8242777631,90.62,156.8,4954,4947,7,0.1414998989
33461,岡山県,矢掛町,矢掛町,14213,15092,-879,-5.8242777631,90.62,156.8,4954,4947,7,0.1414998989
33580,岡山県,真庭郡,真庭郡,866,957,-91,-9.5088819227,67.11,12.9,330,342,-12,-3.5087719298
33586,岡山県,新庄村,新庄村,866,957,-91,-9.5088819227,67.11,12.9,330,342,-12,-3.5087719298
33600,岡山県,苫田郡,苫田郡,12853,13580,-727,-5.3534609720,419.68,30.6,4669,4725,-56,-1.1851851852
33606,岡山県,鏡野町,鏡野町,12853,13580,-727,-5.3534609720,419.68,30.6,4669,4725,-56,-1.1851851852
33620,岡山県,勝田郡,勝田郡,17016,17280,-264,-1.5277777778,123.56,137.7,6028,5917,111,1.8759506507
33622,岡山県,勝央町,勝央町,11117,11195,-78,-0.6967396159,54.05,205.7,4052,3928,124,3.1568228106
33623,岡山県,奈義町,奈義町,5899,6085,-186,-3.0566967954,69.52,84.9,1976,1989,-13,-0.6535947712
33640,岡山県,英田郡,英田郡,1472,1520,-48,-3.1578947368,57.97,25.4,561,557,4,0.7181328546
33643,岡山県,西粟倉村,西粟倉村,1472,1520,-48,-3.1578947368,57.97,25.4,561,557,4,0.7181328546
33660,岡山県,久米郡,久米郡,19360,20938,-1578,-7.5365364409,310.81,62.3,7155,7488,-333,-4.4471153846
33663,岡山県,久米南町,久米南町,4909,5296,-387,-7.3074018127,78.65,62.4,1893,1957,-64,-3.2703117016
33666,岡山県,美咲町,美咲町,14451,15642,-1191,-7.6141158420,232.17,62.2,5262,5531,-269,-4.8634966552
33680,岡山県,加賀郡,加賀郡,11955,13033,-1078,-8.2713112867,268.78,44.5,4375,4460,-85,-1.9058295964
33681,岡山県,吉備中央町,吉備中央町,11955,13033,-1078,-8.2713112867,268.78,44.5,4375,4460,-85,-1.9058295964
34101,広島県,広島市中区,広島市 中区,136684,130482,6202,4.7531460278,15.32,8921.9,76858,73281,3577,4.8812106822
34102,広島県,広島市東区,広島市 東区,120075,120751,-676,-0.5598297323,39.42,3046.0,51673,50605,1068,2.1104633929
34103,広島県,広島市南区,広島市 南区,142719,138190,4529,3.2773717346,26.30,5426.6,68792,66357,2435,3.6695450367
34104,広島県,広島市西区,広島市 西区,191134,186985,4149,2.2188945637,35.61,5367.4,90498,87222,3276,3.7559331361
34105,広島県,広島市安佐南区,広島市 安佐南区,242660,233733,8927,3.8193152015,117.24,2069.8,99413,95188,4225,4.4385846955
34106,広島県,広島市安佐北区,広島市 安佐北区,145074,149633,-4559,-3.0467878075,353.33,410.6,57128,56550,578,1.0221043324
34107,広島県,広島市安芸区,広島市 安芸区,79370,78789,581,0.7374125830,94.08,843.6,31254,30310,944,3.1144836688
34108,広島県,広島市佐伯区,広島市 佐伯区,136791,135280,1511,1.1169426375,225.22,607.4,55822,53394,2428,4.5473274151
34202,広島県,呉市,呉市,228635,239973,-11338,-4.7246981952,352.80,648.1,96815,98654,-1839,-1.8640906603
34203,広島県,竹原市,竹原市,26440,28644,-2204,-7.6944560816,118.23,223.6,11197,11525,-328,-2.8459869848
34204,広島県,三原市,三原市,96205,100509,-4304,-4.2822035838,471.54,204.0,39629,40247,-618,-1.5355181753
34205,広島県,尾道市,尾道市,138628,145202,-6574,-4.5274858473,285.09,486.3,57710,58772,-1062,-1.8069829170
34207,広島県,福山市,福山市,465004,461357,3647,0.7904941293,518.05,897.6,185122,178718,6404,3.5832988283
34208,広島県,府中市,府中市,40084,42563,-2479,-5.8243074971,195.75,204.8,14920,15122,-202,-1.3358021426
34209,広島県,三次市,三次市,53677,56605,-2928,-5.1726879251,778.14,69.0,21343,21786,-443,-2.0334159552
34210,広島県,庄原市,庄原市,37008,40244,-3236,-8.0409502038,1246.49,29.7,14496,15269,-773,-5.0625450259
34211,広島県,大竹市,大竹市,27884,28836,-952,-3.3014287696,78.66,354.5,11738,11851,-113,-0.9535060332
34212,広島県,東広島市,東広島市,192905,190135,2770,1.4568595998,635.16,303.7,84804,80986,3818,4.7143950806
34213,広島県,廿日市市,廿日市市,114937,114038,899,0.7883337133,489.48,234.8,46008,44644,1364,3.0552817848
34214,広島県,安芸高田市,安芸高田市,29485,31487,-2002,-6.3581795662,537.75,54.8,11659,11804,-145,-1.2283971535
34215,広島県,江田島市,江田島市,24351,27031,-2680,-9.9145425622,100.74,241.7,10745,11451,-706,-6.1654004017
34300,広島県,安芸郡,安芸郡,116237,116712,-475,-0.4069847145,73.66,1578.0,47778,46378,1400,3.0186726465
34302,広島県,府中町,府中町,51055,50442,613,1.2152571270,10.41,4904.4,21092,20237,855,4.2249345259
34304,広島県,海田町,海田町,28665,28475,190,0.6672519754,13.79,2078.7,12199,11667,532,4.5598697180
34307,広島県,熊野町,熊野町,23762,24533,-771,-3.1427057433,33.76,703.9,9386,9291,95,1.0224948875
34309,広島県,坂町,坂町,12755,13262,-507,-3.8229527975,15.69,812.9,5101,5183,-82,-1.5820953116
34368,広島県,安芸太田町,安芸太田町,6460,7255,-795,-10.9579600276,341.89,18.9,2774,3017,-243,-8.0543586344
34369,広島県,北広島町,北広島町,18915,19969,-1054,-5.2781811808,646.20,29.3,7738,7699,39,0.5065592934
34420,広島県,豊田郡,豊田郡,8037,8448,-411,-4.8650568182,43.11,186.4,3890,3880,10,0.2577319588
34431,広島県,大崎上島町,大崎上島町,8037,8448,-411,-4.8650568182,43.11,186.4,3890,3880,10,0.2577319588
34460,広島県,世羅郡,世羅郡,16340,17549,-1209,-6.8892814405,278.14,58.7,6239,6504,-265,-4.0744157442
34462,広島県,世羅町,世羅町,16340,17549,-1209,-6.8892814405,278.14,58.7,6239,6504,-265,-4.0744157442
34540,広島県,神石郡,神石郡,9224,10350,-1126,-10.8792270531,381.98,24.1,3538,3753,-215,-5.7287503331
34545,広島県,神石高原町,神石高原町,9224,10350,-1126,-10.8792270531,381.98,24.1,3538,3753,-215,-5.7287503331
35201,山口県,下関市,下関市,268617,280947,-12330,-4.3887281231,715.89,375.2,116301,118178,-1877,-1.5882820830
35202,山口県,宇部市,宇部市,169410,173772,-4362,-2.5101857607,286.65,591.0,73225,72447,778,1.0738884978
35203,山口県,山口市,山口市,197502,196628,874,0.4444941717,1023.23,193.0,84980,81299,3681,4.5277309684
35204,山口県,萩市,萩市,49571,53747,-4176,-7.7697359853,698.31,71.0,21601,22243,-642,-2.8863013083
35206,山口県,防府市,防府市,115981,116611,-630,-0.5402577801,189.37,612.5,47571,46851,720,1.5367868349
35207,山口県,下松市,下松市,55831,55012,819,1.4887660874,89.35,624.9,23726,22653,1073,4.7366794685
35208,山口県,岩国市,岩国市,136809,143857,-7048,-4.8993097312,873.72,156.6,59001,59486,-485,-0.8153178899
35210,山口県,光市,光市,51392,53004,-1612,-3.0412799034,92.13,557.8,20872,20913,-41,-0.1960503036
35211,山口県,長門市,長門市,35452,38349,-2897,-7.5543038932,357.29,99.2,14661,15143,-482,-3.1829888397
35212,山口県,柳井市,柳井市,32966,34730,-1764,-5.0791822632,140.05,235.4,14170,14527,-357,-2.4574929442
35213,山口県,美祢市,美祢市,26166,28630,-2464,-8.6063569682,472.64,55.4,10093,10534,-441,-4.1864438960
35215,山口県,周南市,周南市,144713,149487,-4774,-3.1935887402,656.29,220.5,61975,61841,134,0.2166847237
35216,山口県,山陽小野田市,山陽小野田市,62706,64550,-1844,-2.8567002324,133.09,471.2,25736,25536,200,0.7832080201
35300,山口県,大島郡,大島郡,17203,19084,-1881,-9.8564242297,138.09,124.6,8040,8786,-746,-8.4907807876
35305,山口県,周防大島町,周防大島町,17203,19084,-1881,-9.8564242297,138.09,124.6,8040,8786,-746,-8.4907807876
35320,山口県,玖珂郡,玖珂郡,6288,6378,-90,-1.4111006585,10.58,594.3,2594,2589,5,0.1931247586
35321,山口県,和木町,和木町,6288,6378,-90,-1.4111006585,10.58,594.3,2594,2589,5,0.1931247586
35340,山口県,熊毛郡,熊毛郡,30931,32809,-1878,-5.7240391356,119.69,258.4,12509,12827,-318,-2.4791455524
35341,山口県,上関町,上関町,2804,3332,-528,-15.8463385354,34.69,80.8,1459,1668,-209,-12.5299760192
35343,山口県,田布施町,田布施町,15325,15986,-661,-4.1348680095,50.42,303.9,6105,6115,-10,-0.1635322976
35344,山口県,平生町,平生町,12802,13491,-689,-5.1071084427,34.58,370.2,4945,5044,-99,-1.9627279937
35500,山口県,阿武郡,阿武郡,3469,3743,-274,-7.3203312851,115.95,29.9,1495,1579,-84,-5.3198226726
35502,山口県,阿武町,阿武町,3469,3743,-274,-7.3203312851,115.95,29.9,1495,1579,-84,-5.3198226726
36201,徳島県,徳島市,徳島市,258602,264548,-5946,-2.2476072395,191.25,1352.2,114352,111675,2677,2.3971345422
36202,徳島県,鳴門市,鳴門市,59122,61513,-2391,-3.8869832393,135.66,435.8,23233,22994,239,1.0394015830
36203,徳島県,小松島市,小松島市,38776,40614,-1838,-4.5255330674,45.37,854.7,15235,15201,34,0.2236694954
36204,徳島県,阿南市,阿南市,73100,76063,-2963,-3.8954550833,279.56,261.5,27208,26910,298,1.1073950204
36205,徳島県,吉野川市,吉野川市,41487,44020,-2533,-5.7542026352,144.14,287.8,15711,15794,-83,-0.5255160187
36206,徳島県,阿波市,阿波市,37218,39247,-2029,-5.1698218972,191.11,194.7,13101,13252,-151,-1.1394506490
36207,徳島県,美馬市,美馬市,30530,32484,-1954,-6.0152690555,367.14,83.2,11463,11648,-185,-1.5882554945
36208,徳島県,三好市,三好市,26851,29951,-3100,-10.3502387232,721.42,37.2,11306,12043,-737,-6.1197376069
36300,徳島県,勝浦郡,勝浦郡,6849,7548,-699,-9.2607313196,179.46,38.2,2592,2644,-52,-1.9667170953
36301,徳島県,勝浦町,勝浦町,5303,5765,-462,-8.0138768430,69.83,75.9,1860,1881,-21,-1.1164274322
36302,徳島県,上勝町,上勝町,1546,1783,-237,-13.2922041503,109.63,14.1,732,763,-31,-4.0629095675
36320,徳島県,名東郡,名東郡,2292,2588,-296,-11.4374034003,42.28,54.2,793,834,-41,-4.9160671463
36321,徳島県,佐那河内村,佐那河内村,2292,2588,-296,-11.4374034003,42.28,54.2,793,834,-41,-4.9160671463
36340,徳島県,名西郡,名西郡,30905,31992,-1087,-3.3977244311,202.16,152.9,11488,11284,204,1.8078695498
36341,徳島県,石井町,石井町,25600,25954,-354,-1.3639516067,28.85,887.3,9330,8933,397,4.4441956789
36342,徳島県,神山町,神山町,5305,6038,-733,-12.1397813846,173.30,30.6,2158,2351,-193,-8.2092726499
36360,徳島県,那賀郡,那賀郡,8407,9318,-911,-9.7767761322,694.98,12.1,3489,3708,-219,-5.9061488673
36368,徳島県,那賀町,那賀町,8407,9318,-911,-9.7767761322,694.98,12.1,3489,3708,-219,-5.9061488673
36380,徳島県,海部郡,海部郡,20646,23037,-2391,-10.3789555932,525.03,39.3,8957,9626,-669,-6.9499272803
36383,徳島県,牟岐町,牟岐町,4260,4826,-566,-11.7281392458,56.56,75.3,1871,2059,-188,-9.1306459446
36387,徳島県,美波町,美波町,7101,7765,-664,-8.5511912428,140.82,50.4,2889,3097,-208,-6.7161769454
36388,徳島県,海陽町,海陽町,9285,10446,-1161,-11.1143021252,327.65,28.3,4197,4470,-273,-6.1073825503
36400,徳島県,板野郡,板野郡,97697,97034,663,0.6832656595,110.06,887.7,37011,35115,1896,5.3994019650
36401,徳島県,松茂町,松茂町,15212,15070,142,0.9422694094,14.24,1068.3,5887,5602,285,5.0874687612
36402,徳島県,北島町,北島町,22445,21658,787,3.6337611968,8.74,2568.1,8811,8269,542,6.5546015238
36403,徳島県,藍住町,藍住町,34629,33338,1291,3.8724578559,16.27,2128.4,13123,12098,1025,8.4724747892
36404,徳島県,板野町,板野町,13369,14241,-872,-6.1231655080,36.22,369.1,4927,4897,30,0.6126199714
36405,徳島県,上板町,上板町,12042,12727,-685,-5.3822581912,34.58,348.2,4263,4249,14,0.3294892916
36460,徳島県,美馬郡,美馬郡,8930,10490,-1560,-14.8713060057,194.84,45.8,3839,4286,-447,-10.4293047130
36468,徳島県,つるぎ町,つるぎ町,8930,10490,-1560,-14.8713060057,194.84,45.8,3839,4286,-447,-10.4293047130
36480,徳島県,三好郡,三好郡,14651,15044,-393,-2.6123371444,122.48,119.6,5320,5280,40,0.7575757576
36489,徳島県,東みよし町,東みよし町,14651,15044,-393,-2.6123371444,122.48,119.6,5320,5280,40,0.7575757576
37201,香川県,高松市,高松市,420943,419429,1514,0.3609669336,375.41,1121.3,182005,174278,7727,4.4337208368
37202,香川県,丸亀市,丸亀市,110063,110473,-410,-0.3711314077,111.78,984.6,43816,42983,833,1.9379754787
37203,香川県,坂出市,坂出市,53197,55621,-2424,-4.3580661980,92.51,575.0,21356,21394,-38,-0.1776198934
37204,香川県,善通寺市,善通寺市,32942,33817,-875,-2.5874560132,39.93,825.0,12976,12987,-11,-0.0847000847
37205,香川県,観音寺市,観音寺市,59444,62690,-3246,-5.1778593077,117.84,504.4,21909,22476,-567,-2.5226908703
37206,香川県,さぬき市,さぬき市,50300,53000,-2700,-5.0943396226,158.63,317.1,19737,19698,39,0.1979896436
37207,香川県,東かがわ市,東かがわ市,31046,33625,-2579,-7.6698884758,152.83,203.1,12438,12754,-316,-2.4776540693
37208,香川県,三豊市,三豊市,65566,68512,-2946,-4.2999766464,222.71,294.4,22752,22871,-119,-0.5203095623
37320,香川県,小豆郡,小豆郡,28875,31275,-2400,-7.6738609113,169.96,169.9,12473,13013,-540,-4.1496964574
37322,香川県,土庄町,土庄町,14005,15123,-1118,-7.3927130860,74.37,188.3,6059,6297,-238,-3.7795775766
37324,香川県,小豆島町,小豆島町,14870,16152,-1282,-7.9370975731,95.59,155.6,6414,6716,-302,-4.4967242406
37340,香川県,木田郡,木田郡,27695,28464,-769,-2.7016582350,75.78,365.5,10658,10639,19,0.1785882132
37341,香川県,三木町,三木町,27695,28464,-769,-2.7016582350,75.78,365.5,10658,10639,19,0.1785882132
37360,香川県,香川郡,香川郡,3142,3325,-183,-5.5037593985,14.22,221.0,1516,1510,6,0.3973509934
37364,香川県,直島町,直島町,3142,3325,-183,-5.5037593985,14.22,221.0,1516,1510,6,0.3973509934
37380,香川県,綾歌郡,綾歌郡,42580,43059,-479,-1.1124271349,117.84,361.3,17012,16459,553,3.3598639042
37386,香川県,宇多津町,宇多津町,18958,18434,524,2.8425735055,8.10,2340.5,8464,8050,414,5.1428571429
37387,香川県,綾川町,綾川町,23622,24625,-1003,-4.0730964467,109.75,215.2,8548,8409,139,1.6529908431
37400,香川県,仲多度郡,仲多度郡,50963,52552,-1589,-3.0236717917,227.30,224.2,19668,19412,256,1.3187718937
37403,香川県,琴平町,琴平町,9189,9967,-778,-7.8057590047,8.47,1084.9,3708,3880,-172,-4.4329896907
37404,香川県,多度津町,多度津町,23382,23498,-116,-0.4936590348,24.38,959.1,9508,9177,331,3.6068431949
37406,香川県,まんのう町,まんのう町,18392,19087,-695,-3.6412217740,194.45,94.6,6452,6355,97,1.5263571991
38201,愛媛県,松山市,松山市,515092,517231,-2139,-0.4135482985,429.37,1199.6,230816,224178,6638,2.9610398879
38202,愛媛県,今治市,今治市,158185,166532,-8347,-5.0122498979,419.13,377.4,66980,68249,-1269,-1.8593679028
38203,愛媛県,宇和島市,宇和島市,77473,84210,-6737,-8.0002375015,468.15,165.5,32706,34041,-1335,-3.9217414295
38204,愛媛県,八幡浜市,八幡浜市,34963,38370,-3407,-8.8793328121,132.68,263.5,14993,15849,-856,-5.4009716701
38205,愛媛県,新居浜市,新居浜市,119905,121735,-1830,-1.5032652894,234.46,511.4,50638,50377,261,0.5180935744
38206,愛媛県,西条市,西条市,108244,112091,-3847,-3.4320329018,509.98,212.3,44592,44630,-38,-0.0851445216
38207,愛媛県,大洲市,大洲市,44131,47157,-3026,-6.4168628199,432.22,102.1,18085,18410,-325,-1.7653449212
38210,愛媛県,伊予市,伊予市,36839,38017,-1178,-3.0986137780,194.44,189.5,14026,13959,67,0.4799770757
38213,愛媛県,四国中央市,四国中央市,87467,90187,-2720,-3.0159557364,421.24,207.6,34954,34951,3,0.0085834454
38214,愛媛県,西予市,西予市,38927,42080,-3153,-7.4928707224,514.34,75.7,16370,17096,-726,-4.2466073935
38215,愛媛県,東温市,東温市,34652,35253,-601,-1.7048194480,211.30,164.0,13980,13490,490,3.6323202372
38340,愛媛県,越智郡,越智郡,7122,7648,-526,-6.8776150628,30.38,234.4,3386,3618,-232,-6.4123825318
38356,愛媛県,上島町,上島町,7122,7648,-526,-6.8776150628,30.38,234.4,3386,3618,-232,-6.4123825318
38380,愛媛県,上浮穴郡,上浮穴郡,8460,9644,-1184,-12.2770634591,583.69,14.5,4060,4468,-408,-9.1316025067
38386,愛媛県,久万高原町,久万高原町,8460,9644,-1184,-12.2770634591,583.69,14.5,4060,4468,-408,-9.1316025067
38400,愛媛県,伊予郡,伊予郡,51322,52340,-1018,-1.9449751624,121.99,420.7,19878,19580,298,1.5219611849
38401,愛媛県,松前町,松前町,30070,30359,-289,-0.9519417636,20.41,1473.3,11524,11308,216,1.9101521047
38402,愛媛県,砥部町,砥部町,21252,21981,-729,-3.3165006142,101.59,209.2,8354,8272,82,0.9912959381
38420,愛媛県,喜多郡,喜多郡,16750,18045,-1295,-7.1765031865,299.43,55.9,6475,6722,-247,-3.6745016364
38422,愛媛県,内子町,内子町,16750,18045,-1295,-7.1765031865,299.43,55.9,6475,6722,-247,-3.6745016364
38440,愛媛県,西宇和郡,西宇和郡,9629,10882,-1253,-11.5144274949,93.98,102.5,4486,4884,-398,-8.1490581491
38442,愛媛県,伊方町,伊方町,9629,10882,-1253,-11.5144274949,93.98,102.5,4486,4884,-398,-8.1490581491
38480,愛媛県,北宇和郡,北宇和郡,14776,16010,-1234,-7.7076826983,340.34,43.4,6373,6549,-176,-2.6874331959
38484,愛媛県,松野町,松野町,4068,4377,-309,-7.0596298835,98.45,41.3,1773,1748,25,1.4302059497
38488,愛媛県,鬼北町,鬼北町,10708,11633,-925,-7.9515172355,241.88,44.3,4600,4801,-201,-4.1866277859
38500,愛媛県,南宇和郡,南宇和郡,21903,24061,-2158,-8.9688707868,238.98,91.7,9411,9837,-426,-4.3305885941
38506,愛媛県,愛南町,愛南町,21903,24061,-2158,-8.9688707868,238.98,91.7,9411,9837,-426,-4.3305885941
39201,高知県,高知市,高知市,337360,343393,-6033,-1.7568791443,308.99,1091.8,153676,150857,2819,1.8686570726
39202,高知県,室戸市,室戸市,13523,15210,-1687,-11.0913872452,248.18,54.5,6514,6996,-482,-6.8896512293
39203,高知県,安芸市,安芸市,17602,19547,-1945,-9.9503760168,317.20,55.5,7608,8111,-503,-6.2014548144
39204,高知県,南国市,南国市,47999,49472,-1473,-2.9774417853,125.30,383.1,19496,19377,119,0.6141301543
39205,高知県,土佐市,土佐市,27065,28686,-1621,-5.6508401311,91.49,295.8,10248,10544,-296,-2.8072837633
39206,高知県,須崎市,須崎市,22598,24698,-2100,-8.5027127703,135.44,166.8,9011,9323,-312,-3.3465622654
39208,高知県,宿毛市,宿毛市,20919,22610,-1691,-7.4789915966,286.19,73.1,8917,9213,-296,-3.2128514056
39209,高知県,土佐清水市,土佐清水市,13780,16029,-2249,-14.0308191403,266.34,51.7,6588,7216,-628,-8.7028824834
39210,高知県,四万十市,四万十市,34315,35933,-1618,-4.5028247015,632.29,54.3,14795,14874,-79,-0.5311281431
39211,高知県,香南市,香南市,32979,33830,-851,-2.5155187703,126.48,260.7,12954,12877,77,0.5979653646
39212,高知県,香美市,香美市,27541,28766,-1225,-4.2584996176,537.86,51.2,11994,12245,-251,-2.0498162515
39300,高知県,安芸郡,安芸郡,17204,18819,-1615,-8.5817524842,563.13,30.6,7620,7896,-276,-3.4954407295
39301,高知県,東洋町,東洋町,2583,2947,-364,-12.3515439430,74.06,34.9,1382,1461,-79,-5.4072553046
39302,高知県,奈半利町,奈半利町,3285,3542,-257,-7.2557876906,28.36,115.8,1447,1480,-33,-2.2297297297
39303,高知県,田野町,田野町,2734,2932,-198,-6.7530695771,6.53,418.7,1185,1214,-29,-2.3887973641
39304,高知県,安田町,安田町,2636,2970,-334,-11.2457912458,52.36,50.3,1146,1203,-57,-4.7381546135
39305,高知県,北川村,北川村,1294,1367,-73,-5.3401609364,196.73,6.6,582,598,-16,-2.6755852843
39306,高知県,馬路村,馬路村,822,1013,-191,-18.8548864758,165.48,5.0,391,450,-59,-13.1111111111
39307,高知県,芸西村,芸西村,3850,4048,-198,-4.8913043478,39.60,97.2,1487,1490,-3,-0.2013422819
39340,高知県,長岡郡,長岡郡,7545,8822,-1277,-14.4751756971,449.28,16.8,3749,4070,-321,-7.8869778870
39341,高知県,本山町,本山町,3579,4103,-524,-12.7711430660,134.22,26.7,1698,1758,-60,-3.4129692833
39344,高知県,大豊町,大豊町,3966,4719,-753,-15.9567705022,315.06,12.6,2051,2312,-261,-11.2889273356
39360,高知県,土佐郡,土佐郡,4396,4769,-373,-7.8213461942,307.40,14.3,1945,2012,-67,-3.3300198807
39363,高知県,土佐町,土佐町,3999,4358,-359,-8.2377237265,212.13,18.9,1734,1799,-65,-3.6131183991
39364,高知県,大川村,大川村,397,411,-14,-3.4063260341,95.27,4.2,211,213,-2,-0.9389671362
39380,高知県,吾川郡,吾川郡,28278,31562,-3284,-10.4049173056,803.97,35.2,11934,12846,-912,-7.0994862214
39386,高知県,いの町,いの町,22735,25062,-2327,-9.2849732663,470.97,48.3,9189,9772,-583,-5.9660253786
39387,高知県,仁淀川町,仁淀川町,5543,6500,-957,-14.7230769231,333.00,16.6,2745,3074,-329,-10.7026675342
39400,高知県,高岡郡,高岡郡,57468,62480,-5012,-8.0217669654,1527.48,37.6,23951,25082,-1131,-4.5092097919
39401,高知県,中土佐町,中土佐町,6807,7605,-798,-10.4930966469,193.28,35.2,2918,3121,-203,-6.5043255367
39402,高知県,佐川町,佐川町,13114,13951,-837,-5.9995699233,100.80,130.1,5236,5340,-104,-1.9475655431
39403,高知県,越知町,越知町,5797,6374,-577,-9.0524003765,111.95,51.8,2518,2641,-123,-4.6573267702
39405,高知県,檮原町,檮原町,3608,3984,-376,-9.4377510040,236.45,15.3,1560,1769,-209,-11.8145845110
39410,高知県,日高村,日高村,5026,5447,-421,-7.7290251515,44.85,112.1,1976,2063,-87,-4.2171594765
39411,高知県,津野町,津野町,5796,6407,-611,-9.5364445138,197.85,29.3,2297,2406,-109,-4.5303408146
39412,高知県,四万十町,四万十町,17320,18712,-1392,-7.4390765284,642.30,27.0,7446,7742,-296,-3.8233014725
39420,高知県,幡多郡,幡多郡,17889,19830,-1941,-9.7881996974,376.90,47.5,7972,8370,-398,-4.7550776583
39424,高知県,大月町,大月町,5100,5783,-683,-11.8104789901,102.94,49.5,2370,2573,-203,-7.8896230082
39427,高知県,三原村,三原村,1568,1681,-113,-6.7221891731,85.37,18.4,702,745,-43,-5.7718120805
39428,高知県,黒潮町,黒潮町,11221,12366,-1145,-9.2592592593,188.58,59.5,4900,5052,-152,-3.0087094220
40101,福岡県,北九州市門司区,北九州市 門司区,99677,104469,-4792,-4.5870066718,73.67,1353.0,43078,44232,-1154,-2.6089708808
40103,福岡県,北九州市若松区,北九州市 若松区,82881,85167,-2286,-2.6841382226,71.31,1162.3,33686,33495,191,0.5702343633
40105,福岡県,北九州市戸畑区,北九州市 戸畑区,59137,61583,-2446,-3.9718753552,16.61,3560.3,27827,28064,-237,-0.8444982896
40106,福岡県,北九州市小倉北区,北九州市 小倉北区,182007,181936,71,0.0390247120,39.23,4639.5,91173,89036,2137,2.4001527472
40107,福岡県,北九州市小倉南区,北九州市 小倉南区,212933,214793,-1860,-0.8659500077,171.74,1239.9,88487,86420,2067,2.3918074520
40108,福岡県,北九州市八幡東区,北九州市 八幡東区,68891,71801,-2910,-4.0528683445,36.26,1899.9,31543,32142,-599,-1.8636052517
40109,福岡県,北九州市八幡西区,北九州市 八幡西区,256289,257097,-808,-0.3142782685,83.13,3083.0,110483,107313,3170,2.9539757532
40131,福岡県,福岡市東区,福岡市 東区,306014,292199,13815,4.7279422585,69.36,4412.0,140887,133165,7722,5.7988210115
40132,福岡県,福岡市博多区,福岡市 博多区,228200,212527,15673,7.3745924047,31.62,7217.0,139070,124266,14804,11.9131540405
40133,福岡県,福岡市中央区,福岡市 中央区,192554,178429,14125,7.9163140521,15.39,12511.6,115966,106966,9000,8.4138885253
40134,福岡県,福岡市南区,福岡市 南区,255852,247096,8756,3.5435620164,30.98,8258.6,119589,112423,7166,6.3741405228
40135,福岡県,福岡市西区,福岡市 西区,206974,193280,13694,7.0850579470,84.16,2459.3,88362,78018,10344,13.2584788126
40136,福岡県,福岡市城南区,福岡市 城南区,130973,128659,2314,1.7985527635,15.99,8190.9,64590,62266,2324,3.7323740083
40137,福岡県,福岡市早良区,福岡市 早良区,217943,211553,6390,3.0205196806,95.87,2273.3,95695,90254,5441,6.0285416713
40202,福岡県,大牟田市,大牟田市,117413,123638,-6225,-5.0348598327,81.45,1441.5,49363,49936,-573,-1.1474687600
40203,福岡県,久留米市,久留米市,304499,302402,2097,0.6934477947,229.96,1324.1,121742,116664,5078,4.3526709182
40204,福岡県,直方市,直方市,57180,57686,-506,-0.8771625698,61.76,925.8,23202,22645,557,2.4597041289
40205,福岡県,飯塚市,飯塚市,129246,131492,-2246,-1.7080887050,214.07,603.8,54719,53451,1268,2.3722661877
40206,福岡県,田川市,田川市,48461,50605,-2144,-4.2367355004,54.55,888.4,20909,21198,-289,-1.3633361638
40207,福岡県,柳川市,柳川市,67829,71375,-3546,-4.9681260946,77.15,879.2,23436,23333,103,0.4414348776
40210,福岡県,八女市,八女市,64437,69057,-4620,-6.6901255485,482.44,133.6,22130,22316,-186,-0.8334827030
40211,福岡県,筑後市,筑後市,48350,48512,-162,-0.3339379947,41.78,1157.3,17341,16628,713,4.2879480395
40212,福岡県,大川市,大川市,34839,37448,-2609,-6.9669942320,33.62,1036.3,12688,12577,111,0.8825634094
40213,福岡県,行橋市,行橋市,70601,70468,133,0.1887381506,70.05,1007.9,28653,27634,1019,3.6874864298
40214,福岡県,豊前市,豊前市,25961,27031,-1070,-3.9584181125,111.10,233.7,10086,10095,-9,-0.0891530461
40215,福岡県,中間市,中間市,41808,44210,-2402,-5.4331599186,15.96,2619.5,17415,17801,-386,-2.1684175046
40216,福岡県,小郡市,小郡市,58009,58499,-490,-0.8376211559,45.51,1274.6,20901,20024,877,4.3797443068
40217,福岡県,筑紫野市,筑紫野市,101122,100172,950,0.9483688057,87.73,1152.7,39338,37703,1635,4.3365249450
40218,福岡県,春日市,春日市,110767,106780,3987,3.7338452894,14.15,7828.1,43706,41075,2631,6.4053560560
40219,福岡県,大野城市,大野城市,99575,95087,4488,4.7198881025,26.89,3703.0,39840,36778,3062,8.3256294524
40220,福岡県,宗像市,宗像市,96566,95501,1065,1.1151715689,119.91,805.3,39002,37077,1925,5.1918979421
40221,福岡県,太宰府市,太宰府市,72200,70482,1718,2.4375017735,29.60,2439.2,29103,27850,1253,4.4991023339
40223,福岡県,古賀市,古賀市,57953,57920,33,0.0569751381,42.07,1377.5,22321,21517,804,3.7365803783
40224,福岡県,福津市,福津市,58808,55431,3377,6.0922588443,52.76,1114.6,22250,20482,1768,8.6319695342
40225,福岡県,うきは市,うきは市,29540,31640,-2100,-6.6371681416,117.46,251.5,9937,10219,-282,-2.7595655152
40226,福岡県,宮若市,宮若市,28104,30081,-1977,-6.5722549117,139.99,200.8,10713,11094,-381,-3.4342888048
40227,福岡県,嘉麻市,嘉麻市,38780,42589,-3809,-8.9436239405,135.11,287.0,15677,16472,-795,-4.8263720253
40228,福岡県,朝倉市,朝倉市,52459,56355,-3896,-6.9133173631,246.71,212.6,19066,19064,2,0.0104909778
40229,福岡県,みやま市,みやま市,38163,40732,-2569,-6.3070804282,105.21,362.7,12936,13072,-136,-1.0403916769
40230,福岡県,糸島市,糸島市,96532,98435,-1903,-1.9332554478,215.70,447.5,34664,33765,899,2.6625203613
40300,福岡県,筑紫郡,筑紫郡,50029,49780,249,0.5002008839,74.95,667.5,18138,17619,519,2.9456836370
40305,福岡県,那珂川町,那珂川町,50029,49780,249,0.5002008839,74.95,667.5,18138,17619,519,2.9456836370
40340,福岡県,糟屋郡,糟屋郡,225643,214567,11076,5.1620239832,164.64,1370.5,83932,77375,6557,8.4743134087
40341,福岡県,宇美町,宇美町,37941,38592,-651,-1.6868781095,30.21,1255.9,13109,12867,242,1.8807802907
40342,福岡県,篠栗町,篠栗町,31212,31318,-106,-0.3384635034,38.93,801.7,11537,11060,477,4.3128390597
40343,福岡県,志免町,志免町,45275,43564,1711,3.9275548618,8.69,5210.0,17593,16617,976,5.8735030391
40344,福岡県,須恵町,須恵町,27274,26044,1230,4.7227768392,16.31,1672.2,9909,9077,832,9.1660240167
40345,福岡県,新宮町,新宮町,30339,24679,5660,22.9344787066,18.93,1602.7,10944,8865,2079,23.4517766497
40348,福岡県,久山町,久山町,8231,8373,-142,-1.6959273856,37.44,219.8,2824,2657,167,6.2852841551
40349,福岡県,粕屋町,粕屋町,45371,41997,3374,8.0339071838,14.13,3211.0,18016,16232,1784,10.9906357812
40380,福岡県,遠賀郡,遠賀郡,93634,96669,-3035,-3.1395793895,93.41,1002.4,36854,36690,164,0.4469882802
40381,福岡県,芦屋町,芦屋町,14199,15369,-1170,-7.6127269178,11.60,1224.1,5577,5891,-314,-5.3301646580
40382,福岡県,水巻町,水巻町,29001,30021,-1020,-3.3976216648,11.01,2634.1,12226,12087,139,1.1499958633
40383,福岡県,岡垣町,岡垣町,31587,32119,-532,-1.6563404838,48.64,649.4,11794,11656,138,1.1839396019
40384,福岡県,遠賀町,遠賀町,18847,19160,-313,-1.6336116910,22.15,850.9,7257,7056,201,2.8486394558
40400,福岡県,鞍手郡,鞍手郡,23844,25690,-1846,-7.1856753601,49.78,479.0,9725,10021,-296,-2.9537970262
40401,福岡県,小竹町,小竹町,7815,8602,-787,-9.1490351081,14.18,551.1,3333,3511,-178,-5.0697806893
40402,福岡県,鞍手町,鞍手町,16029,17088,-1059,-6.1973314607,35.60,450.3,6392,6510,-118,-1.8125960061
40420,福岡県,嘉穂郡,嘉穂郡,13509,13863,-354,-2.5535598355,20.14,670.8,5217,5216,1,0.0191717791
40421,福岡県,桂川町,桂川町,13509,13863,-354,-2.5535598355,20.14,670.8,5217,5216,1,0.0191717791
40440,福岡県,朝倉郡,朝倉郡,31506,31587,-81,-0.2564346092,119.06,264.6,10518,10095,423,4.1901931649
40447,福岡県,筑前町,筑前町,29332,29155,177,0.6070999829,67.10,437.1,9756,9297,459,4.9370764763
40448,福岡県,東峰村,東峰村,2174,2432,-258,-10.6085526316,51.97,41.8,762,798,-36,-4.5112781955
40500,福岡県,三井郡,三井郡,15155,15284,-129,-0.8440198901,22.84,663.5,4934,4793,141,2.9417901106
40503,福岡県,大刀洗町,大刀洗町,15155,15284,-129,-0.8440198901,22.84,663.5,4934,4793,141,2.9417901106
40520,福岡県,三潴郡,三潴郡,14181,14350,-169,-1.1777003484,18.44,769.0,4551,4470,81,1.8120805369
40522,福岡県,大木町,大木町,14181,14350,-169,-1.1777003484,18.44,769.0,4551,4470,81,1.8120805369
40540,福岡県,八女郡,八女郡,20194,20253,-59,-0.2913148669,37.94,532.3,6994,6799,195,2.8680688337
40544,福岡県,広川町,広川町,20194,20253,-59,-0.2913148669,37.94,532.3,6994,6799,195,2.8680688337
40600,福岡県,田川郡,田川郡,77713,83943,-6230,-7.4217028222,309.18,251.4,31498,32665,-1167,-3.5726312567
40601,福岡県,香春町,香春町,10866,11685,-819,-7.0089858793,44.50,244.2,4428,4595,-167,-3.6343852013
40602,福岡県,添田町,添田町,9923,10909,-986,-9.0384086534,132.20,75.1,4029,4215,-186,-4.4128113879
40604,福岡県,糸田町,糸田町,9026,9617,-591,-6.1453675782,8.04,1122.6,3805,3924,-119,-3.0326197757
40605,福岡県,川崎町,川崎町,16801,18264,-1463,-8.0102934735,36.14,464.9,7344,7693,-349,-4.5365917067
40608,福岡県,大任町,大任町,5183,5503,-320,-5.8150099945,14.26,363.5,2052,2083,-31,-1.4882381181
40609,福岡県,赤村,赤村,3028,3251,-223,-6.8594278683,31.98,94.7,1122,1157,-35,-3.0250648228
40610,福岡県,福智町,福智町,22886,24714,-1828,-7.3966173019,42.06,544.1,8718,8998,-280,-3.1118026228
40620,福岡県,京都郡,京都郡,55248,57577,-2329,-4.0450179759,200.22,275.9,22869,23263,-394,-1.6936766539
40621,福岡県,苅田町,苅田町,34984,36005,-1021,-2.8357172615,48.88,715.7,15341,15560,-219,-1.4074550129
40625,福岡県,みやこ町,みやこ町,20264,21572,-1308,-6.0634155387,151.34,133.9,7528,7703,-175,-2.2718421394
40640,福岡県,築上郡,築上郡,32688,34188,-1500,-4.3875043875,187.78,174.1,12625,12932,-307,-2.3739560779
40642,福岡県,吉富町,吉富町,6629,6792,-163,-2.3998822144,5.73,1156.9,2588,2645,-57,-2.1550094518
40646,福岡県,上毛町,上毛町,7460,7852,-392,-4.9923586347,62.44,119.5,2786,2843,-57,-2.0049243757
40647,福岡県,築上町,築上町,18599,19544,-945,-4.8352435530,119.61,155.5,7251,7444,-193,-2.5926921010
41201,佐賀県,佐賀市,佐賀市,236398,237506,-1108,-0.4665145302,431.84,547.4,93117,90435,2682,2.9656659479
41202,佐賀県,唐津市,唐津市,122859,126926,-4067,-3.2042292359,487.54,252.0,43836,43651,185,0.4238161783
41203,佐賀県,鳥栖市,鳥栖市,72910,69074,3836,5.5534644005,71.72,1016.6,27580,25219,2361,9.3619889766
41204,佐賀県,多久市,多久市,19742,21404,-1662,-7.7649037563,96.96,203.6,6832,7100,-268,-3.7746478873
41205,佐賀県,伊万里市,伊万里市,55294,57161,-1867,-3.2662129774,255.28,216.6,19695,19614,81,0.4129703273
41206,佐賀県,武雄市,武雄市,49108,50699,-1591,-3.1381289572,195.40,251.3,16932,16674,258,1.5473191796
41207,佐賀県,鹿島市,鹿島市,29700,30720,-1020,-3.3203125000,112.12,264.9,10117,10055,62,0.6166086524
41208,佐賀県,小城市,小城市,44308,45133,-825,-1.8279307824,95.81,462.5,14755,14305,450,3.1457532331
41209,佐賀県,嬉野市,嬉野市,27359,28984,-1625,-5.6065415402,126.41,216.4,9211,9314,-103,-1.1058621430
41210,佐賀県,神埼市,神埼市,31871,32899,-1028,-3.1247150369,125.13,254.7,10933,10741,192,1.7875430593
41320,佐賀県,神埼郡,神埼郡,16434,16405,29,0.1767753734,43.99,373.6,5890,5478,412,7.5209930632
41327,佐賀県,吉野ヶ里町,吉野ヶ里町,16434,16405,29,0.1767753734,43.99,373.6,5890,5478,412,7.5209930632
41340,佐賀県,三養基郡,三養基郡,52086,53236,-1150,-2.1601923510,86.86,599.7,18181,17536,645,3.6781478102
41341,佐賀県,基山町,基山町,17494,17837,-343,-1.9229691092,22.15,789.8,6294,6025,269,4.4647302905
41345,佐賀県,上峰町,上峰町,9296,9224,72,0.7805724198,12.80,726.3,3263,3074,189,6.1483409239
41346,佐賀県,みやき町,みやき町,25296,26175,-879,-3.3581661891,51.92,487.2,8624,8437,187,2.2164276402
41380,佐賀県,東松浦郡,東松浦郡,5904,6379,-475,-7.4463081988,35.90,164.5,1917,1959,-42,-2.1439509954
41387,佐賀県,玄海町,玄海町,5904,6379,-475,-7.4463081988,35.90,164.5,1917,1959,-42,-2.1439509954
41400,佐賀県,西松浦郡,西松浦郡,20166,20929,-763,-3.6456591333,65.85,306.2,6896,6916,-20,-0.2891844997
41401,佐賀県,有田町,有田町,20166,20929,-763,-3.6456591333,65.85,306.2,6896,6916,-20,-0.2891844997
41420,佐賀県,杵島郡,杵島郡,40324,42491,-2167,-5.0999035090,135.54,297.5,13046,13116,-70,-0.5336992986
41423,佐賀県,大町町,大町町,6782,7369,-587,-7.9658026869,11.50,589.7,2561,2694,-133,-4.9368968077
41424,佐賀県,江北町,江北町,9588,9515,73,0.7672096689,24.49,391.5,3231,3076,155,5.0390117035
41425,佐賀県,白石町,白石町,23954,25607,-1653,-6.4552661382,99.56,240.6,7254,7346,-92,-1.2523822488
41440,佐賀県,藤津郡,藤津郡,8782,9842,-1060,-10.7701686649,74.30,118.2,2902,2925,-23,-0.7863247863
41441,佐賀県,太良町,太良町,8782,9842,-1060,-10.7701686649,74.30,118.2,2902,2925,-23,-0.7863247863
42201,長崎県,長崎市,長崎市,429644,443766,-14122,-3.1823077928,405.81,1058.7,189422,187685,1737,0.9254868530
42202,長崎県,佐世保市,佐世保市,255648,261101,-5453,-2.0884638512,426.06,600.0,104998,104583,415,0.3968140137
42203,長崎県,島原市,島原市,45426,47455,-2029,-4.2756295438,82.97,547.5,17083,17039,44,0.2582311168
42204,長崎県,諫早市,諫早市,138136,140752,-2616,-1.8585881551,341.83,404.1,51842,50989,853,1.6729098433
42205,長崎県,大村市,大村市,92812,90517,2295,2.5354353326,126.66,732.8,36080,34044,2036,5.9804958289
42207,長崎県,平戸市,平戸市,31949,34905,-2956,-8.4687007592,235.20,135.8,12388,12885,-497,-3.8571982926
42208,長崎県,松浦市,松浦市,23344,25145,-1801,-7.1624577451,130.67,178.6,8974,9214,-240,-2.6047319297
42209,長崎県,対馬市,対馬市,31468,34407,-2939,-8.5418664807,708.63,44.4,13393,13813,-420,-3.0406139144
42210,長崎県,壱岐市,壱岐市,27106,29377,-2271,-7.7305374953,139.42,194.4,10096,10401,-305,-2.9324103452
42211,長崎県,五島市,五島市,37331,40622,-3291,-8.1015213431,420.04,88.9,17422,18382,-960,-5.2225002720
42212,長崎県,西海市,西海市,28692,31176,-2484,-7.9676674365,241.59,118.8,11504,11875,-371,-3.1242105263
42213,長崎県,雲仙市,雲仙市,44135,47245,-3110,-6.5827071648,214.27,206.0,15361,15863,-502,-3.1645968606
42214,長崎県,南島原市,南島原市,46564,50363,-3799,-7.5432361059,170.11,273.7,16654,17160,-506,-2.9487179487
42300,長崎県,西彼杵郡,西彼杵郡,72376,72645,-269,-0.3702938950,49.67,1457.1,27353,26265,1088,4.1423948220
42307,長崎県,長与町,長与町,42562,42535,27,0.0634771365,28.73,1481.4,16228,15478,750,4.8455872852
42308,長崎県,時津町,時津町,29814,30110,-296,-0.9830621056,20.94,1423.8,11125,10787,338,3.1334013164
42320,長崎県,東彼杵郡,東彼杵郡,37238,38781,-1543,-3.9787524819,167.63,222.1,12810,12671,139,1.0969931339
42321,長崎県,東彼杵町,東彼杵町,8301,8903,-602,-6.7617656970,74.29,111.7,2741,2747,-6,-0.2184200946
42322,長崎県,川棚町,川棚町,14072,14651,-579,-3.9519486724,37.34,376.9,5108,5144,-36,-0.6998444790
42323,長崎県,波佐見町,波佐見町,14865,15227,-362,-2.3773560123,56.00,265.4,4961,4780,181,3.7866108787
42380,長崎県,北松浦郡,北松浦郡,16189,16448,-259,-1.5746595331,57.80,280.1,6312,6171,141,2.2848808945
42383,長崎県,小値賀町,小値賀町,2560,2849,-289,-10.1439101439,25.53,100.3,1210,1287,-77,-5.9829059829
42391,長崎県,佐々町,佐々町,13629,13599,30,0.2206044562,32.27,422.3,5102,4884,218,4.4635544636
42400,長崎県,南松浦郡,南松浦郡,19722,22074,-2352,-10.6550693123,213.94,92.2,8989,9620,-631,-6.5592515593
42411,長崎県,新上五島町,新上五島町,19722,22074,-2352,-10.6550693123,213.94,92.2,8989,9620,-631,-6.5592515593
43101,熊本県,熊本市中央区,熊本市 中央区,186264,184353,1911,1.0365982653,25.45,7318.8,95766,92242,3524,3.8203855077
43102,熊本県,熊本市東区,熊本市 東区,190480,188082,2398,1.2749758084,50.19,3795.2,78326,74942,3384,4.5154919805
43103,熊本県,熊本市西区,熊本市 西区,93178,93805,-627,-0.6684078674,89.33,1043.1,38978,37610,1368,3.6373304972
43104,熊本県,熊本市南区,熊本市 南区,127981,122600,5381,4.3890701468,110.01,1163.4,47199,43499,3700,8.5059426653
43105,熊本県,熊本市北区,熊本市 北区,143212,145634,-2422,-1.6630731835,115.34,1241.7,55201,54120,1081,1.9974131559
43202,熊本県,八代市,八代市,127540,132266,-4726,-3.5731026870,681.36,187.2,47823,47458,365,0.7691010999
43203,熊本県,人吉市,人吉市,33891,35611,-1720,-4.8299682682,210.55,161.0,13831,14001,-170,-1.2141989858
43204,熊本県,荒尾市,荒尾市,53453,55321,-1868,-3.3766562427,57.37,931.7,20901,20898,3,0.0143554407
43205,熊本県,水俣市,水俣市,25418,26978,-1560,-5.7824894358,163.29,155.7,10638,10893,-255,-2.3409529055
43206,熊本県,玉名市,玉名市,66802,69541,-2739,-3.9386836542,152.60,437.8,24477,24344,133,0.5463358528
43208,熊本県,山鹿市,山鹿市,52278,55391,-3113,-5.6200465780,299.69,174.4,19140,19308,-168,-0.8701056557
43210,熊本県,菊池市,菊池市,48209,50194,-1985,-3.9546559350,276.85,174.1,16959,16706,253,1.5144259547
43211,熊本県,宇土市,宇土市,37053,37727,-674,-1.7865189387,74.30,498.7,13284,12808,476,3.7164272330
43212,熊本県,上天草市,上天草市,26998,29902,-2904,-9.7117249682,126.91,212.7,10472,10994,-522,-4.7480443878
43213,熊本県,宇城市,宇城市,59781,61878,-2097,-3.3889265975,188.60,317.0,21434,21077,357,1.6937894387
43214,熊本県,阿蘇市,阿蘇市,27038,28444,-1406,-4.9430459851,376.30,71.9,10048,10100,-52,-0.5148514851
43215,熊本県,天草市,天草市,82770,89065,-6295,-7.0678717790,683.78,121.0,33227,34272,-1045,-3.0491363212
43216,熊本県,合志市,合志市,58402,55002,3400,6.1815933966,53.19,1098.0,20574,18913,1661,8.7823190398
43340,熊本県,下益城郡,下益城郡,10341,11388,-1047,-9.1938883035,144.00,71.8,3611,3791,-180,-4.7480875758
43348,熊本県,美里町,美里町,10341,11388,-1047,-9.1938883035,144.00,71.8,3611,3791,-180,-4.7480875758
43360,熊本県,玉名郡,玉名郡,41152,43959,-2807,-6.3854955754,211.46,194.6,15051,15181,-130,-0.8563335749
43364,熊本県,玉東町,玉東町,5264,5554,-290,-5.2214620094,24.33,216.4,1825,1825,0,0.0000000000
43367,熊本県,南関町,南関町,9790,10564,-774,-7.3267701628,68.92,142.0,3576,3681,-105,-2.8524857376
43368,熊本県,長洲町,長洲町,15900,16594,-694,-4.1822345426,19.43,818.3,6138,6051,87,1.4377788795
43369,熊本県,和水町,和水町,10198,11247,-1049,-9.3269316262,98.78,103.2,3512,3624,-112,-3.0905077263
43400,熊本県,菊池郡,菊池郡,74476,68968,5508,7.9863124928,136.56,545.4,28656,25602,3054,11.9287555660
43403,熊本県,大津町,大津町,33480,31234,2246,7.1908817314,99.10,337.8,12703,11478,1225,10.6725910437
43404,熊本県,菊陽町,菊陽町,40996,37734,3262,8.6447235915,37.46,1094.4,15953,14124,1829,12.9495893515
43420,熊本県,阿蘇郡,阿蘇郡,37393,39392,-1999,-5.0746344435,703.25,53.2,14441,14507,-66,-0.4549527814
43423,熊本県,南小国町,南小国町,4051,4429,-378,-8.5346579363,115.90,35.0,1642,1702,-60,-3.5252643948
43424,熊本県,小国町,小国町,7188,7877,-689,-8.7469848927,136.94,52.5,2791,2875,-84,-2.9217391304
43425,熊本県,産山村,産山村,1510,1606,-96,-5.9775840598,60.81,24.8,534,575,-41,-7.1304347826
43428,熊本県,高森町,高森町,6327,6716,-389,-5.7921381775,175.06,36.1,2458,2524,-66,-2.6148969889
43432,熊本県,西原村,西原村,6805,6792,13,0.1914016490,77.22,88.1,2341,2221,120,5.4029716344
43433,熊本県,南阿蘇村,南阿蘇村,11512,11972,-460,-3.8422986970,137.32,83.8,4675,4610,65,1.4099783080
43440,熊本県,上益城郡,上益城郡,85814,87402,-1588,-1.8168920620,783.96,109.5,30212,29688,524,1.7650229049
43441,熊本県,御船町,御船町,17243,17888,-645,-3.6057692308,99.03,174.1,6307,6224,83,1.3335475578
43442,熊本県,嘉島町,嘉島町,9057,8676,381,4.3914246196,16.65,544.0,3171,2930,241,8.2252559727
43443,熊本県,益城町,益城町,33632,32676,956,2.9256946995,65.68,512.1,11438,10935,503,4.5999085505
43444,熊本県,甲佐町,甲佐町,10718,11181,-463,-4.1409534031,57.93,185.0,3704,3693,11,0.2978608178
43447,熊本県,山都町,山都町,15164,16981,-1817,-10.7001943348,544.67,27.8,5592,5906,-314,-5.3166271588
43460,熊本県,八代郡,八代郡,12001,12715,-714,-5.6154148643,33.36,359.7,3873,3973,-100,-2.5169896803
43468,熊本県,氷川町,氷川町,12001,12715,-714,-5.6154148643,33.36,359.7,3873,3973,-100,-2.5169896803
43480,熊本県,葦北郡,葦北郡,22346,24378,-2032,-8.3353843630,268.07,83.4,8229,8622,-393,-4.5581071677
43482,熊本県,芦北町,芦北町,17668,19316,-1648,-8.5317871195,233.97,75.5,6484,6796,-312,-4.5909358446
43484,熊本県,津奈木町,津奈木町,4678,5062,-384,-7.5859344133,34.09,137.2,1745,1826,-81,-4.4359255203
43500,熊本県,球磨郡,球磨郡,54957,59116,-4159,-7.0353203870,1326.02,41.4,19252,19683,-431,-2.1897068536
43501,熊本県,錦町,錦町,10774,11075,-301,-2.7178329571,85.04,126.7,3630,3602,28,0.7773459189
43505,熊本県,多良木町,多良木町,9798,10554,-756,-7.1631608869,165.86,59.1,3535,3614,-79,-2.1859435529
43506,熊本県,湯前町,湯前町,3990,4375,-385,-8.8000000000,48.37,82.5,1479,1515,-36,-2.3762376238
43507,熊本県,水上村,水上村,2232,2405,-173,-7.1933471933,190.96,11.7,822,854,-32,-3.7470725995
43510,熊本県,相良村,相良村,4461,4934,-473,-9.5865423591,94.54,47.2,1506,1529,-23,-1.5042511445
43511,熊本県,五木村,五木村,1046,1205,-159,-13.1950207469,252.92,4.1,468,503,-35,-6.9582504970
43512,熊本県,山江村,山江村,3424,3681,-257,-6.9817984243,121.19,28.3,1149,1163,-14,-1.2037833190
43513,熊本県,球磨村,球磨村,3700,4249,-549,-12.9206872205,207.58,17.8,1368,1489,-121,-8.1262592344
43514,熊本県,あさぎり町,あさぎり町,15532,16638,-1106,-6.6474335858,159.56,97.3,5295,5414,-119,-2.1980051718
43520,熊本県,天草郡,天草郡,7741,8314,-573,-6.8919894154,67.55,114.6,2894,3002,-108,-3.5976015989
43531,熊本県,苓北町,苓北町,7741,8314,-573,-6.8919894154,67.55,114.6,2894,3002,-108,-3.5976015989
44201,大分県,大分市,大分市,478335,474094,4241,0.8945483385,502.39,952.1,203286,195623,7663,3.9172285467
44202,大分県,別府市,別府市,122193,125385,-3192,-2.5457590621,125.29,975.3,55467,56070,-603,-1.0754414125
44203,大分県,中津市,中津市,83967,84312,-345,-0.4091944207,491.54,170.8,35789,34574,1215,3.5142014230
44204,大分県,日田市,日田市,66526,70940,-4414,-6.2221595715,666.03,99.9,25135,25551,-416,-1.6281163164
44205,大分県,佐伯市,佐伯市,72203,76951,-4748,-6.1701602318,903.08,80.0,29575,30511,-936,-3.0677460588
44206,大分県,臼杵市,臼杵市,38768,41469,-2701,-6.5132990909,291.20,133.1,15050,15394,-344,-2.2346368715
44207,大分県,津久見市,津久見市,17973,19917,-1944,-9.7605061003,79.47,226.2,7516,7978,-462,-5.7909250439
44208,大分県,竹田市,竹田市,22342,24423,-2081,-8.5206567580,477.53,46.8,9133,9588,-455,-4.7455152274
44209,大分県,豊後高田市,豊後高田市,22868,23906,-1038,-4.3420061909,206.24,110.9,9539,9665,-126,-1.3036730471
44210,大分県,杵築市,杵築市,30204,32083,-1879,-5.8566842253,280.06,107.8,12141,12181,-40,-0.3283802643
44211,大分県,宇佐市,宇佐市,56277,59008,-2731,-4.6281860087,439.05,128.2,22450,22869,-419,-1.8321745594
44212,大分県,豊後大野市,豊後大野市,36598,39452,-2854,-7.2341072696,603.14,60.7,14223,14854,-631,-4.2480140030
44213,大分県,由布市,由布市,34276,34702,-426,-1.2275949513,319.32,107.3,13284,12874,410,3.1847133758
44214,大分県,国東市,国東市,28650,32002,-3352,-10.4743453534,318.07,90.1,12102,13139,-1037,-7.8925336784
44320,大分県,東国東郡,東国東郡,1992,2189,-197,-8.9995431704,6.98,285.4,877,913,-36,-3.9430449069
44322,大分県,姫島村,姫島村,1992,2189,-197,-8.9995431704,6.98,285.4,877,913,-36,-3.9430449069
44340,大分県,速見郡,速見郡,28067,28221,-154,-0.5456929237,73.33,382.7,10893,10517,376,3.5751640202
44341,大分県,日出町,日出町,28067,28221,-154,-0.5456929237,73.33,382.7,10893,10517,376,3.5751640202
44460,大分県,玖珠郡,玖珠郡,25490,27475,-1985,-7.2247497725,557.88,45.7,9449,9750,-301,-3.0871794872
44461,大分県,九重町,九重町,9659,10421,-762,-7.3121581422,271.37,35.6,3471,3601,-130,-3.6101083032
44462,大分県,玖珠町,玖珠町,15831,17054,-1223,-7.1713381025,286.51,55.3,5978,6149,-171,-2.7809399902
45201,宮崎県,宮崎市,宮崎市,401156,400583,573,0.1430415170,643.67,623.2,175360,170136,5224,3.0704847886
45202,宮崎県,都城市,都城市,165098,169602,-4504,-2.6556290610,653.36,252.7,69934,69856,78,0.1116582684
45203,宮崎県,延岡市,延岡市,125212,131182,-5970,-4.5509292433,868.02,144.3,51710,52454,-744,-1.4183856331
45204,宮崎県,日南市,日南市,54124,57689,-3565,-6.1796876354,536.10,101.0,22644,23228,-584,-2.5142069916
45205,宮崎県,小林市,小林市,46245,48270,-2025,-4.1951522685,562.95,82.1,19484,19576,-92,-0.4699632203
45206,宮崎県,日向市,日向市,61777,63223,-1446,-2.2871423374,336.93,183.4,24780,24791,-11,-0.0443709411
45207,宮崎県,串間市,串間市,18787,20453,-1666,-8.1455043270,295.16,63.7,7946,8417,-471,-5.5958179874
45208,宮崎県,西都市,西都市,30704,32614,-1910,-5.8563806954,438.79,70.0,12002,12197,-195,-1.5987537919
45209,宮崎県,えびの市,えびの市,19538,21606,-2068,-9.5714153476,282.93,69.1,8566,9078,-512,-5.6400088125
45340,宮崎県,北諸県郡,北諸県郡,25410,24800,610,2.4596774194,110.02,231.0,9967,9503,464,4.8826686310
45341,宮崎県,三股町,三股町,25410,24800,610,2.4596774194,110.02,231.0,9967,9503,464,4.8826686310
45360,宮崎県,西諸県郡,西諸県郡,9304,10000,-696,-6.9600000000,85.39,109.0,3914,4042,-128,-3.1667491341
45361,宮崎県,高原町,高原町,9304,10000,-696,-6.9600000000,85.39,109.0,3914,4042,-128,-3.1667491341
45380,宮崎県,東諸県郡,東諸県郡,26957,28133,-1176,-4.1801443145,225.82,119.4,10500,10597,-97,-0.9153534019
45382,宮崎県,国富町,国富町,19608,20909,-1301,-6.2222009661,130.63,150.1,7562,7746,-184,-2.3754195714
45383,宮崎県,綾町,綾町,7349,7224,125,1.7303433001,95.19,77.2,2938,2851,87,3.0515608558
45400,宮崎県,児湯郡,児湯郡,71265,74389,-3124,-4.1995456317,715.03,99.7,27389,27569,-180,-0.6529072509
45401,宮崎県,高鍋町,高鍋町,21039,21733,-694,-3.1933005107,43.80,480.3,8675,8668,7,0.0807568066
45402,宮崎県,新富町,新富町,17388,18092,-704,-3.8912226398,61.53,282.6,6376,6362,14,0.2200565860
45403,宮崎県,西米良村,西米良村,1089,1241,-152,-12.2481869460,271.51,4.0,509,598,-89,-14.8829431438
45404,宮崎県,木城町,木城町,5231,5177,54,1.0430751400,145.96,35.8,1958,1897,61,3.2156035846
45405,宮崎県,川南町,川南町,16116,17009,-893,-5.2501616791,90.12,178.8,5930,6020,-90,-1.4950166113
45406,宮崎県,都農町,都農町,10402,11137,-735,-6.5996228787,102.11,101.9,3941,4024,-83,-2.0626242545
45420,宮崎県,東臼杵郡,東臼杵郡,28204,30076,-1872,-6.2242319457,1294.20,21.8,10986,11278,-292,-2.5891115446
45421,宮崎県,門川町,門川町,18172,18854,-682,-3.6172695449,120.51,150.8,6840,6840,0,0.0000000000
45429,宮崎県,諸塚村,諸塚村,1740,1882,-142,-7.5451647184,187.56,9.3,689,719,-30,-4.1724617524
45430,宮崎県,椎葉村,椎葉村,2808,3092,-284,-9.1849935317,537.29,5.2,1128,1203,-75,-6.2344139651
45431,宮崎県,美郷町,美郷町,5484,6248,-764,-12.2279129321,448.84,12.2,2329,2516,-187,-7.4324324324
45440,宮崎県,西臼杵郡,西臼杵郡,20596,22613,-2017,-8.9196479901,686.93,30.0,7438,7783,-345,-4.4327380188
45441,宮崎県,高千穂町,高千穂町,12759,13723,-964,-7.0247030533,237.54,53.7,4668,4794,-126,-2.6282853567
45442,宮崎県,日之影町,日之影町,3947,4463,-516,-11.5617297782,277.67,14.2,1493,1621,-128,-7.8963602714
45443,宮崎県,五ヶ瀬町,五ヶ瀬町,3890,4427,-537,-12.1301106844,171.73,22.7,1277,1368,-91,-6.6520467836
46201,鹿児島県,鹿児島市,鹿児島市,600008,605846,-5838,-0.9636112147,547.57,1095.8,270169,264686,5483,2.0715111491
46203,鹿児島県,鹿屋市,鹿屋市,103662,105070,-1408,-1.3400590083,448.38,231.2,44932,44404,528,1.1890820647
46204,鹿児島県,枕崎市,枕崎市,22059,23638,-1579,-6.6799221592,74.78,295.0,10074,10434,-360,-3.4502587694
46206,鹿児島県,阿久根市,阿久根市,21197,23154,-1957,-8.4521033083,134.28,157.9,9194,9830,-636,-6.4699898271
46208,鹿児島県,出水市,出水市,53778,55621,-1843,-3.3134967009,329.98,163.0,22509,22555,-46,-0.2039459100
46210,鹿児島県,指宿市,指宿市,41843,44396,-2553,-5.7505180647,148.84,281.1,18491,19210,-719,-3.7428422697
46213,鹿児島県,西之表市,西之表市,15958,16951,-993,-5.8580614713,205.66,77.6,7356,7569,-213,-2.8141101863
46214,鹿児島県,垂水市,垂水市,15524,17248,-1724,-9.9953617811,162.12,95.8,6984,7470,-486,-6.5060240964
46215,鹿児島県,薩摩川内市,薩摩川内市,96109,99589,-3480,-3.4943618271,682.94,140.7,40724,41449,-725,-1.7491374943
46216,鹿児島県,日置市,日置市,49263,50822,-1559,-3.0675691630,252.99,194.7,19649,19916,-267,-1.3406306487
46217,鹿児島県,曽於市,曽於市,36570,39221,-2651,-6.7591341373,390.11,93.7,16120,16859,-739,-4.3834153864
46218,鹿児島県,霧島市,霧島市,125900,127487,-1587,-1.2448328065,603.18,208.7,54324,53971,353,0.6540549554
46219,鹿児島県,いちき串木野市,いちき串木野市,29290,31144,-1854,-5.9529925507,112.30,260.8,12172,12315,-143,-1.1611855461
46220,鹿児島県,南さつま市,南さつま市,35440,38704,-3264,-8.4332368747,283.59,125.0,15365,16419,-1054,-6.4193921676
46221,鹿児島県,志布志市,志布志市,31490,33034,-1544,-4.6739722710,290.28,108.5,13896,14149,-253,-1.7881122341
46222,鹿児島県,奄美市,奄美市,43184,46121,-2937,-6.3680319160,308.25,140.1,19632,20114,-482,-2.3963408571
46223,鹿児島県,南九州市,南九州市,36384,39065,-2681,-6.8629207731,357.91,101.7,15336,16069,-733,-4.5615781940
46224,鹿児島県,伊佐市,伊佐市,26804,29304,-2500,-8.5312585313,392.56,68.3,12115,12798,-683,-5.3367713705
46225,鹿児島県,姶良市,姶良市,75209,74809,400,0.5346950233,231.25,325.2,31377,30478,899,2.9496686134
46300,鹿児島県,鹿児島郡,鹿児島郡,1165,1075,90,8.3720930233,132.54,8.8,615,638,-23,-3.6050156740
46303,鹿児島県,三島村,三島村,407,418,-11,-2.6315789474,31.40,13.0,223,242,-19,-7.8512396694
46304,鹿児島県,十島村,十島村,758,657,101,15.3729071537,101.14,7.5,392,396,-4,-1.0101010101
46380,鹿児島県,薩摩郡,薩摩郡,22411,24109,-1698,-7.0430129827,303.90,73.7,9708,9969,-261,-2.6181161601
46392,鹿児島県,さつま町,さつま町,22411,24109,-1698,-7.0430129827,303.90,73.7,9708,9969,-261,-2.6181161601
46400,鹿児島県,出水郡,出水郡,10436,11105,-669,-6.0243133724,116.12,89.9,4138,4303,-165,-3.8345340460
46404,鹿児島県,長島町,長島町,10436,11105,-669,-6.0243133724,116.12,89.9,4138,4303,-165,-3.8345340460
46440,鹿児島県,姶良郡,姶良郡,10321,11595,-1274,-10.9874946097,144.29,71.5,4322,4653,-331,-7.1136900924
46452,鹿児島県,湧水町,湧水町,10321,11595,-1274,-10.9874946097,144.29,71.5,4322,4653,-331,-7.1136900924
46460,鹿児島県,曽於郡,曽於郡,13248,14215,-967,-6.8026732325,100.67,131.6,6079,6380,-301,-4.7178683386
46468,鹿児島県,大崎町,大崎町,13248,14215,-967,-6.8026732325,100.67,131.6,6079,6380,-301,-4.7178683386
46480,鹿児島県,肝属郡,肝属郡,37672,41764,-4092,-9.7979120774,712.61,52.9,16807,18291,-1484,-8.1132797551
46482,鹿児島県,東串良町,東串良町,6538,6802,-264,-3.8812114084,27.78,235.3,2829,2964,-135,-4.5546558704
46490,鹿児島県,錦江町,錦江町,7920,8987,-1067,-11.8727050184,163.19,48.5,3442,3804,-362,-9.5162986330
46491,鹿児島県,南大隅町,南大隅町,7545,8815,-1270,-14.4072603517,213.54,35.3,3559,4005,-446,-11.1360799001
46492,鹿児島県,肝付町,肝付町,15669,17160,-1491,-8.6888111888,308.10,50.9,6977,7518,-541,-7.1960627827
46500,鹿児島県,熊毛郡,熊毛郡,26796,28503,-1707,-5.9888432797,788.66,34.0,12597,13028,-431,-3.3082591342
46501,鹿児島県,中種子町,中種子町,8136,8696,-560,-6.4397424103,137.82,59.0,3741,3946,-205,-5.1951343132
46502,鹿児島県,南種子町,南種子町,5745,6218,-473,-7.6069475716,110.36,52.1,2724,2834,-110,-3.8814396613
46505,鹿児島県,屋久島町,屋久島町,12915,13589,-674,-4.9598940319,540.48,23.9,6132,6248,-116,-1.8565941101
46520,鹿児島県,大島郡,大島郡,67031,72652,-5621,-7.7368826736,932.24,71.9,29881,31429,-1548,-4.9253873811
46523,鹿児島県,大和村,大和村,1529,1765,-236,-13.3711048159,88.26,17.3,709,831,-122,-14.6811070999
46524,鹿児島県,宇検村,宇検村,1719,1932,-213,-11.0248447205,103.07,16.7,866,935,-69,-7.3796791444
46525,鹿児島県,瀬戸内町,瀬戸内町,9050,9874,-824,-8.3451488758,239.63,37.8,4414,4677,-263,-5.6232627753
46527,鹿児島県,龍郷町,龍郷町,5809,6078,-269,-4.4257979599,82.01,70.8,2414,2468,-54,-2.1880064830
46529,鹿児島県,喜界町,喜界町,7213,8169,-956,-11.7027787979,56.97,126.6,3364,3634,-270,-7.4298293891
46530,鹿児島県,徳之島町,徳之島町,11164,12090,-926,-7.6592224979,104.92,106.4,4959,5230,-271,-5.1816443595
46531,鹿児島県,天城町,天城町,5980,6653,-673,-10.1157372614,80.40,74.4,2623,2841,-218,-7.6733544527
46532,鹿児島県,伊仙町,伊仙町,6369,6844,-475,-6.9403857393,62.71,101.6,2885,3035,-150,-4.9423393740
46533,鹿児島県,和泊町,和泊町,6790,7114,-324,-4.5543997751,40.39,168.1,2910,2909,1,0.0343760743
46534,鹿児島県,知名町,知名町,6218,6806,-588,-8.6394357919,53.30,116.7,2680,2862,-182,-6.3591893781
46535,鹿児島県,与論町,与論町,5190,5327,-137,-2.5718040173,20.58,252.2,2057,2007,50,2.4912805182
47201,沖縄県,那覇市,那覇市,319449,315954,3495,1.1061736835,39.57,8073.0,135094,129512,5582,4.3100253258
47205,沖縄県,宜野湾市,宜野湾市,96297,91928,4369,4.7526324950,19.80,4863.5,39297,36361,2936,8.0745854074
47207,沖縄県,石垣市,石垣市,47660,46922,738,1.5728229828,229.27,207.9,20532,19212,1320,6.8707058089
47208,沖縄県,浦添市,浦添市,114285,110351,3934,3.5649880835,19.48,5866.8,44027,40927,3100,7.5744618467
47209,沖縄県,名護市,名護市,61711,60231,1480,2.4572064219,210.90,292.6,26144,24277,1867,7.6904065576
47210,沖縄県,糸満市,糸満市,58557,57320,1237,2.1580600140,46.62,1256.0,20583,19249,1334,6.9302301418
47211,沖縄県,沖縄市,沖縄市,139315,130249,9066,6.9605140922,49.72,2802.0,53360,47999,5361,11.1689826871
47212,沖縄県,豊見城市,豊見城市,61128,57261,3867,6.7532875779,19.60,3118.8,21771,19332,2439,12.6163873371
47213,沖縄県,うるま市,うるま市,119019,116979,2040,1.7439027518,87.01,1367.9,42389,38344,4045,10.5492384728
47214,沖縄県,宮古島市,宮古島市,51196,52039,-843,-1.6199388920,204.18,250.7,21965,21196,769,3.6280430270
47215,沖縄県,南城市,南城市,42006,39758,2248,5.6542079581,49.94,841.1,14324,12676,1648,13.0009466709
47300,沖縄県,国頭郡,国頭郡,64581,64608,-27,-0.0417904903,577.21,111.9,25390,24401,989,4.0531125774
47301,沖縄県,国頭村,国頭村,4922,5188,-266,-5.1272166538,194.80,25.3,2064,2114,-50,-2.3651844844
47302,沖縄県,大宜味村,大宜味村,3060,3221,-161,-4.9984476871,63.55,48.2,1261,1267,-6,-0.4735595896
47303,沖縄県,東村,東村,1721,1794,-73,-4.0691192865,81.88,21.0,793,691,102,14.7612156295
47306,沖縄県,今帰仁村,今帰仁村,9527,9257,270,2.9167116776,39.93,238.6,3468,3368,100,2.9691211401
47308,沖縄県,本部町,本部町,13549,13870,-321,-2.3143475126,54.33,249.4,5239,5049,190,3.7631214102
47311,沖縄県,恩納村,恩納村,10679,10144,535,5.2740536278,50.82,210.1,4028,3801,227,5.9721126019
47313,沖縄県,宜野座村,宜野座村,5597,5331,266,4.9896829863,31.30,178.8,2001,1823,178,9.7641250686
47314,沖縄県,金武町,金武町,11264,11066,198,1.7892644135,37.84,297.7,4649,4373,276,6.3114566659
47315,沖縄県,伊江村,伊江村,4262,4737,-475,-10.0274435297,22.78,187.1,1887,1915,-28,-1.4621409922
47320,沖縄県,中頭郡,中頭郡,151655,147688,3967,2.6860679270,107.31,1413.2,54741,50868,3873,7.6138240151
47324,沖縄県,読谷村,読谷村,39493,38200,1293,3.3848167539,35.28,1119.4,13640,12422,1218,9.8051843503
47325,沖縄県,嘉手納町,嘉手納町,13708,13827,-119,-0.8606349895,15.12,906.6,5069,4937,132,2.6736884748
47326,沖縄県,北谷町,北谷町,28329,27264,1065,3.9062500000,13.93,2033.7,10709,9903,806,8.1389477936
47327,沖縄県,北中城村,北中城村,16163,15951,212,1.3290702777,11.54,1400.6,5538,5220,318,6.0919540230
47328,沖縄県,中城村,中城村,19452,17680,1772,10.0226244344,15.53,1252.5,7196,6268,928,14.8053605616
47329,沖縄県,西原町,西原町,34510,34766,-256,-0.7363516079,15.90,2170.4,12589,12118,471,3.8867799967
47340,沖縄県,島尻郡,島尻郡,100245,94783,5462,5.7626367598,234.88,426.8,36463,32625,3838,11.7639846743
47348,沖縄県,与那原町,与那原町,18429,16318,2111,12.9366343915,5.18,3557.7,7021,5805,1216,20.9474590870
47350,沖縄県,南風原町,南風原町,37518,35244,2274,6.4521620701,10.76,3486.8,12711,11254,1457,12.9465079083
47353,沖縄県,渡嘉敷村,渡嘉敷村,731,760,-29,-3.8157894737,19.23,38.0,417,429,-12,-2.7972027972
47354,沖縄県,座間味村,座間味村,870,865,5,0.5780346821,16.74,52.0,446,459,-13,-2.8322440087
47355,沖縄県,粟国村,粟国村,710,863,-153,-17.7288528389,7.65,92.8,385,379,6,1.5831134565
47356,沖縄県,渡名喜村,渡名喜村,430,452,-22,-4.8672566372,3.87,111.1,267,246,21,8.5365853659
47357,沖縄県,南大東村,南大東村,1329,1442,-113,-7.8363384189,30.53,43.5,685,713,-28,-3.9270687237
47358,沖縄県,北大東村,北大東村,629,665,-36,-5.4135338346,13.09,48.1,333,378,-45,-11.9047619048
47359,沖縄県,伊平屋村,伊平屋村,1238,1385,-147,-10.6137184116,21.82,56.7,511,523,-12,-2.2944550669
47360,沖縄県,伊是名村,伊是名村,1516,1589,-73,-4.5940843298,15.42,98.3,696,699,-3,-0.4291845494
47361,沖縄県,久米島町,久米島町,7761,8519,-758,-8.8977579528,63.65,121.9,3359,3601,-242,-6.7203554568
47362,沖縄県,八重瀬町,八重瀬町,29084,26681,2403,9.0064090551,26.96,1078.8,9632,8139,1493,18.3437768768
47370,沖縄県,宮古郡,宮古郡,1196,1231,-35,-2.8432168968,21.99,54.4,468,499,-31,-6.2124248497
47375,沖縄県,多良間村,多良間村,1196,1231,-35,-2.8432168968,21.99,54.4,468,499,-31,-6.2124248497
47380,沖縄県,八重山郡,八重山郡,5838,5516,322,5.8375634518,363.35,16.1,3196,2713,483,17.8031699226
47381,沖縄県,竹富町,竹富町,3995,3859,136,3.5242290749,334.39,11.9,2116,2000,116,5.8000000000
47382,沖縄県,与那国町,与那国町,1843,1657,186,11.2251056126,28.96,63.6,1080,713,367,51.4726507714
